a	Präposition
abitare	Verb
aceto	Substantiv
acqua	Substantiv
adesso	Adverb
aereo	Substantiv
aeroplano	Substantiv
aeroporto	Substantiv
affetto	Substantiv
agenzia	Substantiv
agosto	Substantiv
aiuto	Interjektion
albergo	Substantiv
albero	Substantiv
alfabeto	Substantiv
alto	Adjektiv
amare	Verb
ambasciata	Substantiv
amica	Substantiv
amico	Substantiv
amore	Substantiv
anche	Konjunktion
andare	Verb
animale	Substantiv
anno	Substantiv
appartamento	Substantiv
appuntamento	Substantiv
aprile	Substantiv
aprire	Verb
arrivare	Verb
arrivederci	Interjektion
arte	Substantiv
ascoltare	Verb
aspettare	Verb
attento	Adjektiv
attenzione	Substantiv
augurio	Substantiv
autobus	Substantiv
autunno	Substantiv
avanti	Adverb
avere	Verb
bacio	Substantiv
bagno	Substantiv
ballare	Verb
bambina	Substantiv
bambino	Substantiv
banca	Substantiv
bar	Substantiv
bello	Adjektiv
bene	Adverb
bere	Verb
bianco	Adjektiv
bicchiere	Substantiv
bici	Substantiv
bicicletta	Substantiv
biglietto	Substantiv
biondo	Adjektiv
birra	Substantiv
blu	Adjektiv
borsa	Substantiv
bottiglia	Substantiv
bravo	Adjektiv
bravo	Interjektion
buonanotte	Interjektion
buonasera	Interjektion
buongiorno	Interjektion
buono	Adjektiv
busta	Substantiv
caffè	Substantiv
caldo	Adjektiv
calza	Substantiv
cambiare	Verb
camera	Substantiv
cameriera	Substantiv
cameriere	Substantiv
camicia	Substantiv
campagna	Substantiv
cane	Substantiv
cantare	Verb
canzone	Substantiv
capello	Substantiv
capire	Verb
cappotto	Substantiv
cappuccino	Substantiv
carne	Substantiv
caro	Adjektiv
carta	Substantiv
cartolina	Substantiv
casa	Substantiv
castano	Adjektiv
cd	Substantiv
cellulare	Substantiv
cena	Substantiv
cenare	Verb
centro	Substantiv
cercare	Verb
certo	Adverb
che	Pronomen
check-in	Substantiv
chi	Pronomen
chiamare	Verb
chiamarsi	Verb
chiave	Substantiv
chiesa	Substantiv
chiudere	Verb
ci	Pronominalpartikel
ciao	Interjektion
cibo	Substantiv
cin-cin	Interjektion
cinema	Substantiv
città	Substantiv
classe	Substantiv
cognome	Substantiv
colazione	Substantiv
colore	Substantiv
coltello	Substantiv
come	Adverb
cominciare	Verb
compagna	Substantiv
compagno	Substantiv
compleanno	Substantiv
comprare	Verb
computer	Substantiv
con	Präposition
consolato	Substantiv
conto	Substantiv
corso	Substantiv
corto	Adjektiv
cosa	Substantiv
costare	Verb
credito	Substantiv
cucchiaio	Substantiv
cucina	Substantiv
dare	Verb
data	Substantiv
davanti	Adverb
dentro	Adverb
destra	Substantiv
di	Präposition
dicembre	Substantiv
dietro	Adverb
difficile	Adjektiv
dire	Verb
doccia	Substantiv
documento	Substantiv
domanda	Substantiv
domandare	Verb
domani	Adverb
domenica	Substantiv
donna	Substantiv
dopo	Adverb
doppio	Adjektiv
dormire	Verb
dottore	Substantiv
dottoressa	Substantiv
dove	Adverb
dovere	Verb
e	Konjunktion
e-mail	Substantiv
entrare	Verb
esercizio	Substantiv
essere	Verb
estate	Substantiv
estero	Substantiv
euro	Substantiv
fabbrica	Substantiv
facile	Adjektiv
falso	Adjektiv
fame	Substantiv
famiglia	Substantiv
fare	Verb
farmacia	Substantiv
favore	Substantiv
fax	Substantiv
febbraio	Substantiv
felice	Adjektiv
femmina	Substantiv
fermata	Substantiv
festa	Substantiv
figlia	Substantiv
figlio	Substantiv
film	Substantiv
finestra	Substantiv
finire	Verb
fiore	Substantiv
forchetta	Substantiv
fotografia	Substantiv
francobollo	Substantiv
fratello	Substantiv
freddo	Adjektiv
frutta	Substantiv
fumare	Verb
fuori	Adverb
gatto	Substantiv
gennaio	Substantiv
gentile	Adjektiv
giacca	Substantiv
giallo	Adjektiv
giardino	Substantiv
giocare	Verb
giornale	Substantiv
giornata	Substantiv
giorno	Substantiv
giovane	Adjektiv
giovedì	Substantiv
giù	Adverb
giugno	Substantiv
gli	Artikel
gonna	Substantiv
grande	Adjektiv
grazie	Interjektion
guardare	Verb
hobby	Substantiv
hotel	Substantiv
i	Artikel
ieri	Adverb
il	Artikel
imparare	Verb
importante	Adjektiv
in	Präposition
incontrare	Verb
indietro	Adverb
indirizzo	Substantiv
industria	Substantiv
informazione	Substantiv
insegnante	Substantiv
insegnare	Verb
intelligente	Adjektiv
interessante	Adjektiv
internazionale	Adjektiv
internet	Substantiv
inverno	Substantiv
io	Pronomen
italiano	Substantiv
la	Artikel
là	Adverb
lago	Substantiv
largo	Adjektiv
latte	Substantiv
lavorare	Verb
lavoro	Substantiv
le	Artikel
leggere	Verb
lei	Pronomen
lettera	Substantiv
letto	Substantiv
lezione	Substantiv
lì	Adverb
libro	Substantiv
lingua	Substantiv
lo	Artikel
lontano	Adverb
loro	Pronomen
luglio	Substantiv
lui	Pronomen
lunedì	Substantiv
lungo	Adjektiv
macchina	Substantiv
madre	Substantiv
maggio	Substantiv
maglietta	Substantiv
maglione	Substantiv
magro	Adjektiv
mai	Adverb
malato	Adjektiv
male	Adverb
mamma	Substantiv
mangiare	Verb
mare	Substantiv
marito	Substantiv
martedì	Substantiv
marzo	Substantiv
maschio	Substantiv
matita	Substantiv
mattina	Substantiv
me	Pronomen
medicina	Substantiv
meno	Adverb
menù	Substantiv
mercato	Substantiv
mercoledì	Substantiv
mese	Substantiv
metà	Substantiv
mettere	Verb
mezzanotte	Substantiv
mezzo	Adjektiv
mezzogiorno	Substantiv
mi	Pronomen
minuto	Substantiv
mio	Adjektiv
moglie	Substantiv
molto	Adjektiv
molto	Adverb
momento	Substantiv
montagna	Substantiv
morire	Verb
moto	Substantiv
motocicletta	Substantiv
museo	Substantiv
musica	Substantiv
nascere	Verb
Natale	Substantiv
nazionalità	Substantiv
nazione	Substantiv
negozio	Substantiv
nero	Adjektiv
nessuno	Pronomen
niente	Pronomen
niente	Adverb
no	Adverb
noi	Pronomen
nome	Substantiv
non	Adverb
nonna	Substantiv
nonno	Substantiv
notte	Substantiv
novembre	Substantiv
numero	Substantiv
nuovo	Adjektiv
o	Konjunktion
occhiale	Substantiv
oggi	Adverb
olio	Substantiv
ombrello	Substantiv
ora	Substantiv
ora	Adverb
orologio	Substantiv
ospedale	Substantiv
ottobre	Substantiv
pacco	Substantiv
padre	Substantiv
pagare	Verb
pane	Substantiv
pantalone	Substantiv
papà	Substantiv
parcheggio	Substantiv
parco	Substantiv
parlare	Verb
parola	Substantiv
partire	Verb
Pasqua	Substantiv
passaporto	Substantiv
pasta	Substantiv
penna	Substantiv
pepe	Substantiv
per	Präposition
perché	Adverb
perché	Konjunktion
pesce	Substantiv
piacere	Verb
piacere	Substantiv
piano	Adverb
piano	Substantiv
pianta	Substantiv
piatto	Substantiv
piazza	Substantiv
piccolo	Adjektiv
piovere	Verb
più	Adverb
pizza	Substantiv
pizzeria	Substantiv
po’	Adverb
poco	Adjektiv
poco	Adverb
polizia	Substantiv
pomeriggio	Substantiv
pomodoro	Substantiv
porta	Substantiv
portare	Verb
posta	Substantiv
posto	Substantiv
potere	Verb
pranzare	Verb
pranzo	Substantiv
prego	Interjektion
prendere	Verb
prenotare	Verb
presto	Adverb
prezzo	Substantiv
primavera	Substantiv
professore	Substantiv
professoressa	Substantiv
pulire	Verb
qua	Adverb
quaderno	Substantiv
quadro	Substantiv
quale	Pronomen
quando	Adverb
quanto	Adjektiv
quanto	Pronomen
quanto	Adverb
quarto	Substantiv
quasi	Adverb
quello	Adjektiv
quello	Pronomen
questo	Adjektiv
questo	Pronomen
qui	Adverb
radio	Substantiv
ragazza	Substantiv
ragazzo	Substantiv
ricco	Adjektiv
ripetere	Verb
riso	Substantiv
rispondere	Verb
risposta	Substantiv
ristorante	Substantiv
ritornare	Verb
rosso	Adjektiv
sabato	Substantiv
sale	Substantiv
salute	Interjektion
saluto	Substantiv
sapere	Verb
scarpa	Substantiv
scrivere	Verb
scuola	Substantiv
scusare	Verb
secondo	Substantiv
sedia	Substantiv
segreteria	Substantiv
sempre	Adverb
senza	Präposition
sera	Substantiv
sete	Substantiv
settembre	Substantiv
settimana	Substantiv
si	Pronomen
sì	Adverb
sigaretta	Substantiv
significare	Verb
signora	Substantiv
signore	Substantiv
simpatico	Adjektiv
singolo	Adjektiv
sinistra	Substantiv
soggiorno	Substantiv
soldo	Substantiv
sole	Substantiv
sonno	Substantiv
sopra	Adverb
sorella	Substantiv
sotto	Adverb
spaghetto	Substantiv
spedire	Verb
spesa	Substantiv
spesso	Adverb
spiaggia	Substantiv
sporco	Adjektiv
sport	Substantiv
sposare	Verb
stanco	Adjektiv
stare	Verb
stazione	Substantiv
stop	Substantiv
strada	Substantiv
straniero	Adjektiv
stretto	Adjektiv
studente	Substantiv
studentessa	Substantiv
studiare	Verb
su	Adverb
suonare	Verb
supermercato	Substantiv
svegliarsi	Verb
tanto	Adjektiv
tanto	Adverb
tardi	Adverb
tavolo	Substantiv
taxi	Substantiv
te	Pronomen
tè	Substantiv
teatro	Substantiv
telefonare	Verb
telefono	Substantiv
televisione	Substantiv
ti	Pronomen
tornare	Verb
treno	Substantiv
triste	Adjektiv
troppo	Adjektiv
troppo	Adverb
trovare	Verb
tu	Pronomen
tuo	Adjektiv
turista	Substantiv
tutto	Adjektiv
tv	Substantiv
ufficio	Substantiv
un	Artikel
una	Artikel
uno	Artikel
università	Substantiv
uomo	Substantiv
uovo	Substantiv
uscire	Verb
vacanza	Substantiv
valigia	Substantiv
vecchio	Adjektiv
vedersi	Verb
venerdì	Substantiv
venire	Verb
verde	Adjektiv
verdura	Substantiv
vero	Adjektiv
vestito	Substantiv
via	Substantiv
viaggiare	Verb
viaggio	Substantiv
vicino	Adverb
vino	Substantiv
visitare	Verb
visto	Substantiv
vivere	Verb
voi	Pronomen
volere	Verb
zaino	Substantiv
zucchero	Substantiv
