a	Präposition
abbandonare	Verb
abbassare	Verb
abbastanza	Adverb
abbonamento	Substantiv
abbondante	Adjektiv
abbracciare	Verb
abbraccio	Substantiv
abile	Adjektiv
abilità	Substantiv
abitante	Substantiv
abitare	Verb
abitazione	Substantiv
abituarsi	Verb
abitudine	Substantiv
accadere	Verb
accanto	Adverb
accarezzare	Verb
accelerare	Verb
accendere	Verb
accendino	Substantiv
accento	Substantiv
accettare	Verb
accidenti	Interjektion
accogliere	Verb
accomodarsi	Verb
accompagnare	Verb
acconto	Substantiv
accordo	Substantiv
accorgersi	Verb
accusare	Verb
aceto	Substantiv
acido	Adjektiv
acqua	Substantiv
acquistare	Verb
adatto	Adjektiv
addetta	Substantiv
addetto	Substantiv
addio	Interjektion
addormentarsi	Verb
adesso	Adverb
adolescente	Substantiv
adoperare	Verb
adorare	Verb
adottare	Verb
adulta	Adjektiv
adulta	Substantiv
adulto	Adjektiv
adulto	Substantiv
aereo	Substantiv
aeroplano	Substantiv
aeroporto	Substantiv
affare	Substantiv
affatto	Adverb
affermare	Verb
affermazione	Substantiv
affetto	Substantiv
affettuoso	Adjektiv
affinché	Konjunktion
affittare	Verb
affitto	Substantiv
affrontare	Verb
agenzia	Substantiv
aggiungere	Verb
aggiustare	Verb
agio	Substantiv
aglio	Substantiv
agosto	Substantiv
agricoltura	Substantiv
agriturismo	Substantiv
aiutare	Verb
aiuto	Interjektion
aiuto	Substantiv
alba	Substantiv
albergo	Substantiv
albero	Substantiv
alcuno	Adjektiv
alfabeto	Substantiv
alimentari	Substantiv
alimentazione	Substantiv
allarme	Substantiv
allegro	Adjektiv
allergico	Adjektiv
alloggio	Substantiv
allontanarsi	Verb
allora	Adverb
almeno	Adverb
alto	Adjektiv
altrettanto	Adjektiv
altrimenti	Adverb
altro	Pronomen
altro	Adjektiv
alzarsi	Verb
amare	Verb
amaro	Adjektiv
ambasciata	Substantiv
ambiente	Substantiv
ambulanza	Substantiv
ambulatorio	Substantiv
amicizia	Substantiv
amica	Substantiv
amico	Substantiv
ammalarsi	Verb
ammazzare	Verb
ammettere	Verb
amministratore	Substantiv
amministratrice	Substantiv
ammirare	Verb
ammobiliato	Adjektiv
amore	Substantiv
ampio	Adjektiv
analisi	Substantiv
anche	Konjunktion
ancora	Adverb
andare	Verb
andarsene	Verb
anello	Substantiv
angolo	Substantiv
animale	Substantiv
anno	Substantiv
annoiarsi	Verb
annullare	Verb
annuncio	Substantiv
ansia	Substantiv
ansioso	Adjektiv
anticipo	Substantiv
antico	Adjektiv
antipasto	Substantiv
antipatico	Adjektiv
anziana	Adjektiv
anziana	Substantiv
anziano	Adjektiv
anziano	Substantiv
aperitivo	Substantiv
appartamento	Substantiv
appartenere	Verb
appassionato	Adjektiv
appena	Adverb
appetito	Substantiv
apprezzare	Verb
appuntamento	Substantiv
appunto	Substantiv
appunto	Adverb
aprile	Substantiv
aprire	Verb
arancia	Substantiv
arancione	Adjektiv
argento	Substantiv
argomento	Substantiv
aria	Substantiv
arma	Substantiv
armadio	Substantiv
armonia	Substantiv
arrabbiarsi	Verb
arrestare	Verb
arrivare	Verb
arrivederci	Interjektion
arrivo	Substantiv
arrosto	Substantiv
arte	Substantiv
articolo	Substantiv
artificiale	Adjektiv
artigianato	Substantiv
ascensore	Substantiv
asciugamano	Substantiv
asciugare	Verb
asciugarsi	Verb
ascoltare	Verb
asilo	Substantiv
asma	Substantiv
aspettare	Verb
aspettarsi	Verb
aspetto	Substantiv
aspro	Adjektiv
assassina	Substantiv
assassino	Substantiv
assegno	Substantiv
assente	Adjektiv
assenza	Substantiv
assicurare	Verb
assicurazione	Substantiv
associazione	Substantiv
assolutamente	Adverb
assomigliare	Verb
assumere	Verb
assurdo	Adjektiv
atteggiamento	Substantiv
attendere	Verb
attentamente	Adverb
attentato	Substantiv
attento	Adjektiv
attenzione	Substantiv
attesa	Substantiv
attimo	Substantiv
attività	Substantiv
attore	Substantiv
attrice	Substantiv
attraversare	Verb
attraverso	Präposition
augurare	Verb
augurarsi	Verb
augurio	Substantiv
aula	Substantiv
aumentare	Verb
aumento	Substantiv
autentico	Adjektiv
auto	Substantiv
automobile	Substantiv
autobus	Substantiv
autore	Substantiv
autrice	Substantiv
autostrada	Substantiv
autunno	Substantiv
avanti	Adverb
avaro	Adjektiv
avere	Verb
avverbio	Substantiv
avvertire	Verb
avvicinarsi	Verb
azienda	Substantiv
azione	Substantiv
azzurro	Adjektiv
baciare	Verb
bacio	Substantiv
baffo	Substantiv
bagaglio	Substantiv
bagnare	Verb
bagnarsi	Verb
bagno	Substantiv
balcone	Substantiv
ballare	Verb
bambina	Substantiv
bambino	Substantiv
bambola	Substantiv
banana	Substantiv
banca	Substantiv
banco	Substantiv
bancomat	Substantiv
banconota	Substantiv
bar	Substantiv
barba	Substantiv
barca	Substantiv
base	Substantiv
basso	Adjektiv
basta	Interjektion
bastare	Verb
beato	Adjektiv
beh	Interjektion
bellezza	Substantiv
bello	Adjektiv
benché	Konjunktion
bene	Adverb
benvenuto	Adjektiv
benzina	Substantiv
bere	Verb
bianco	Adjektiv
bibita	Substantiv
biblioteca	Substantiv
bicchiere	Substantiv
bici	Substantiv
bicicletta	Substantiv
biglietteria	Substantiv
biglietto	Substantiv
bilancia	Substantiv
bilocale	Substantiv
binario	Substantiv
biondo	Adjektiv
birra	Substantiv
bisognare	Verb
bisogno	Substantiv
bistecca	Substantiv
blu	Adjektiv
bocca	Substantiv
bocciare	Verb
boh	Interjektion
bollente	Adjektiv
bolletta	Substantiv
bollettino	Substantiv
bollire	Verb
bomba	Substantiv
bonifico	Substantiv
borsa	Substantiv
bosco	Substantiv
bottiglia	Substantiv
braccio	Substantiv
brano	Substantiv
bravo	Adjektiv
bravo	Interjektion
breve	Adjektiv
bruciarsi	Verb
brutto	Adjektiv
bugia	Substantiv
buio	Substantiv
buonanotte	Interjektion
buonasera	Interjektion
buongiorno	Interjektion
buono	Adjektiv
burro	Substantiv
busta	Substantiv
buttare	Verb
cadavere	Substantiv
cadere	Verb
caffè	Substantiv
calcio	Substantiv
calcolare	Verb
caldo	Adjektiv
caldo	Substantiv
calma	Substantiv
calmarsi	Verb
calmo	Adjektiv
calza	Substantiv
cambiare	Verb
camera	Substantiv
cameriera	Substantiv
cameriere	Substantiv
camicia	Substantiv
camion	Substantiv
camminare	Verb
campagna	Substantiv
campeggio	Substantiv
camper	Substantiv
campo	Substantiv
canale	Substantiv
cane	Substantiv
canguro	Substantiv
cantante	Substantiv
cantare	Verb
cantiere	Substantiv
cantina	Substantiv
canzone	Substantiv
capace	Adjektiv
capacità	Substantiv
capello	Substantiv
capire	Verb
capitale	Substantiv
capitare	Verb
capo	Substantiv
capodanno	Substantiv
cappello	Substantiv
cappotto	Substantiv
cappuccino	Substantiv
carabiniere	Substantiv
carattere	Substantiv
carcere	Substantiv
caricare	Verb
carne	Substantiv
carnevale	Substantiv
caro	Adjektiv
carota	Substantiv
carriera	Substantiv
carta	Substantiv
cartolina	Substantiv
cartone	Substantiv
casa	Substantiv
casalinga	Substantiv
casalingo	Substantiv
caso	Substantiv
cassa	Substantiv
cassettiera	Substantiv
castano	Adjektiv
cattivo	Adjektiv
catturare	Verb
causa	Substantiv
cavallo	Substantiv
cavarsela	Verb
cavolo	Interjektion
cd	Substantiv
celibe	Adjektiv
cellulare	Substantiv
cena	Substantiv
cenare	Verb
centimetro	Substantiv
centro	Substantiv
cercare	Verb
cerotto	Substantiv
certamente	Adverb
certificato	Substantiv
certo	Adjektiv
certo	Adverb
cervello	Substantiv
che	Pronomen
che	Konjunktion
check-in	Substantiv
chi	Pronomen
chiacchierare	Verb
chiamare	Verb
chiamarsi	Verb
chiaro	Adjektiv
chiave	Substantiv
chiedere	Verb
chiesa	Substantiv
chilo	Substantiv
chilometro	Substantiv
chissà	Adverb
chiudere	Verb
chiunque	Pronomen
ci	Pronomen
ci	Pronominalpartikel
ciao	Interjektion
ciascuno	Pronomen
cibo	Substantiv
cieco	Adjektiv
cieco	Substantiv
cielo	Substantiv
cima	Substantiv
cimitero	Substantiv
cin-cin	Interjektion
cinema	Substantiv
ciò	Pronomen
cioccolato	Substantiv
cioè	Konjunktion
cipolla	Substantiv
circa	Adverb
citare	Verb
città	Substantiv
cittadinanza	Substantiv
classe	Substantiv
classico	Adjektiv
cliccare	Verb
cliente	Substantiv
clima	Substantiv
clinica	Substantiv
coda	Substantiv
cogliere	Verb
cognata	Substantiv
cognato	Substantiv
cognome	Substantiv
coincidenza	Substantiv
colazione	Substantiv
collaboratore	Substantiv
collaboratrice	Substantiv
collana	Substantiv
collega	Substantiv
collegio	Substantiv
collezionare	Verb
collezione	Substantiv
collina	Substantiv
collocamento	Substantiv
colloquio	Substantiv
colorare	Verb
colore	Substantiv
colpa	Substantiv
colpevole	Adjektiv
colpevole	Substantiv
coltello	Substantiv
combattere	Verb
come	Adverb
come	Konjunktion
cominciare	Verb
commedia	Substantiv
commentare	Verb
commento	Substantiv
commercio	Substantiv
commessa	Substantiv
commesso	Substantiv
comodino	Substantiv
comodo	Adjektiv
compagnia	Substantiv
compagna	Substantiv
compagno	Substantiv
compilare	Verb
compito	Substantiv
compleanno	Substantiv
complemento	Substantiv
complesso	Adjektiv
completo	Adjektiv
complicare	Verb
complimento	Substantiv
comportamento	Substantiv
comportarsi	Verb
comprare	Verb
comprendere	Verb
computer	Substantiv
Comune	Substantiv
comunicare	Verb
comunicazione	Substantiv
comunque	Konjunktion
comunque	Adverb
con	Präposition
concentrare	Verb
concentrarsi	Verb
concerto	Substantiv
concorrenza	Substantiv
concorso	Substantiv
concludere	Verb
conclusione	Substantiv
condannare	Verb
condividere	Verb
condizionare	Verb
condizione	Substantiv
condoglianza	Substantiv
condominio	Substantiv
conferenza	Substantiv
confermare	Verb
confine	Substantiv
confrontare	Verb
confronto	Substantiv
confuso	Adjektiv
congratulazione	Substantiv
coniugare	Verb
coniuge	Substantiv
connettersi	Verb
conoscenza	Substantiv
conoscere	Verb
consegnare	Verb
conseguenza	Substantiv
considerare	Verb
considerazione	Substantiv
consigliare	Verb
consiglio	Substantiv
consolato	Substantiv
consonante	Substantiv
contante	Substantiv
contare	Verb
contattare	Verb
contatto	Substantiv
contemporaneamente	Adverb
contemporaneo	Adjektiv
contento	Adjektiv
continuare	Verb
continuamente	Adverb
conto	Substantiv
contorno	Substantiv
contrario	Substantiv
contratto	Substantiv
contro	Präposition
controllare	Verb
conversazione	Substantiv
convincere	Verb
convivente	Substantiv
coperta	Substantiv
copia	Substantiv
coppia	Substantiv
coraggio	Interjektion
coraggio	Substantiv
cordiale	Adjektiv
cordialmente	Adverb
corpo	Substantiv
correggere	Verb
corrente	Adjektiv
corrente	Substantiv
correre	Verb
corso	Substantiv
cortesia	Substantiv
corto	Adjektiv
cosa	Substantiv
così	Adverb
costare	Verb
costo	Substantiv
costoso	Adjektiv
costringere	Verb
costruire	Verb
costruzione	Substantiv
cotone	Substantiv
creare	Verb
credere	Verb
credito	Substantiv
crema	Substantiv
crepare	Verb
crescere	Verb
criminale	Substantiv
crisi	Substantiv
criticare	Verb
crociera	Substantiv
cronaca	Substantiv
crudo	Adjektiv
cucchiaio	Substantiv
cucina	Substantiv
cucinare	Verb
cugina	Substantiv
cugino	Substantiv
cui	Pronomen
cultura	Substantiv
cuocere	Verb
cuore	Substantiv
cura	Substantiv
curarsi	Verb
curioso	Adjektiv
curriculum vitae	Substantiv
cuscino	Substantiv
da	Präposition
danno	Substantiv
dappertutto	Adverb
dare	Verb
data	Substantiv
dato	Substantiv
davanti	Adverb
davanti	Präposition
davvero	Adverb
debito	Substantiv
debole	Adjektiv
decidere	Verb
decisione	Substantiv
deludere	Verb
delusione	Substantiv
democrazia	Substantiv
denaro	Substantiv
dente	Substantiv
dentifricio	Substantiv
dentista	Substantiv
dentro	Adverb
dentro	Präposition
denuncia	Substantiv
denunciare	Verb
deprimere	Verb
descrivere	Verb
deserto	Substantiv
desiderare	Verb
desiderio	Substantiv
destinatario	Substantiv
destra	Substantiv
detestare	Verb
dettato	Substantiv
di	Präposition
dialetto	Substantiv
dialogo	Substantiv
diario	Substantiv
diavolo	Substantiv
dicembre	Substantiv
dichiarare	Verb
dieta	Substantiv
dietro	Adverb
dietro	Präposition
difendere	Verb
difetto	Substantiv
differente	Adjektiv
differenza	Substantiv
difficile	Adjektiv
difficoltà	Substantiv
dimenticare	Verb
dimenticarsi	Verb
diminuire	Verb
dimostrare	Verb
Dio	Substantiv
dipendente	Substantiv
dipendenza	Substantiv
dipendere	Verb
dipingere	Verb
dipinto	Substantiv
diploma	Substantiv
diplomarsi	Verb
dire	Verb
direttamente	Adverb
direttore	Substantiv
direttrice	Substantiv
direzione	Substantiv
dirigente	Substantiv
disabile	Adjektiv
discesa	Substantiv
discorso	Substantiv
discoteca	Substantiv
discussione	Substantiv
discutere	Verb
disgustoso	Adjektiv
disegnare	Verb
disoccupata	Adjektiv
disoccupata	Substantiv
disoccupato	Adjektiv
disoccupato	Substantiv
dispensa	Substantiv
disperare	Verb
dispiacere	Verb
distanza	Substantiv
distinto	Adjektiv
distributore	Substantiv
disturbare	Verb
dito	Substantiv
ditta	Substantiv
divano	Substantiv
diventare	Verb
diverso	Adjektiv
divertente	Adjektiv
divertimento	Substantiv
divertirsi	Verb
dividere	Verb
divieto	Substantiv
divorziare	Verb
dizionario	Substantiv
doccia	Substantiv
documentario	Substantiv
documento	Substantiv
dogana	Substantiv
dolce	Adjektiv
dolce	Substantiv
dolore	Substantiv
domanda	Substantiv
domandare	Verb
domani	Adverb
domenica	Substantiv
donna	Substantiv
dopo	Adverb
dopo	Präposition
dopodomani	Adverb
doppio	Adjektiv
dormire	Verb
dottorato	Substantiv
dottore	Substantiv
dottoressa	Substantiv
dove	Adverb
dovere	Verb
dovunque	Adverb
dritto	Adverb
droga	Substantiv
dubbio	Substantiv
dubitare	Verb
dunque	Konjunktion
duomo	Substantiv
durante	Präposition
durare	Verb
duro	Adjektiv
e	Konjunktion
eccetera	Adverb
eccetto	Präposition
eccezionale	Adjektiv
ecco	Adverb
economia	Substantiv
educazione	Substantiv
egoista	Adjektiv
egregio	Adjektiv
eh	Interjektion
elegante	Adjektiv
elementare	Adjektiv
elettricista	Substantiv
elezione	Substantiv
elicottero	Substantiv
e-mail	Substantiv
emergenza	Substantiv
emozione	Substantiv
enorme	Adjektiv
entrare	Verb
entrata	Substantiv
entro	Präposition
epoca	Substantiv
erba	Substantiv
errore	Substantiv
esame	Substantiv
esatto	Adjektiv
esatto	Adverb
escludere	Verb
esempio	Substantiv
esercito	Substantiv
esercizio	Substantiv
esistere	Verb
esperienza	Substantiv
espressione	Substantiv
esprimere	Verb
essere	Verb
est	Substantiv
estate	Substantiv
esterno	Adjektiv
estero	Substantiv
estroverso	Adjektiv
età	Substantiv
etto	Substantiv
euro	Substantiv
evidente	Adjektiv
evidenza	Substantiv
fabbrica	Substantiv
faccia	Substantiv
facile	Adjektiv
facoltà	Substantiv
falso	Adjektiv
fame	Substantiv
famiglia	Substantiv
famoso	Adjektiv
fantastico	Adjektiv
farcela	Verb
fare	Verb
farina	Substantiv
farmacia	Substantiv
fastidio	Substantiv
fatica	Substantiv
fattoria	Substantiv
favola	Substantiv
favore	Substantiv
fax	Substantiv
febbraio	Substantiv
febbre	Substantiv
fede	Substantiv
felice	Adjektiv
felicità	Substantiv
femmina	Substantiv
femminile	Adjektiv
feriale	Adjektiv
feria	Substantiv
ferire	Verb
ferirsi	Verb
ferita	Substantiv
fermare	Verb
fermarsi	Verb
fermata	Substantiv
fermo	Adjektiv
ferro	Substantiv
festa	Substantiv
festeggiare	Verb
festivo	Adjektiv
fetta	Substantiv
fiammifero	Substantiv
fiction	Substantiv
fidanzata	Substantiv
fidanzato	Substantiv
fidarsi	Verb
fiducia	Substantiv
figlia	Substantiv
figlio	Substantiv
figo	Adjektiv
figura	Substantiv
figurarsi	Verb
fila	Substantiv
film	Substantiv
finale	Adjektiv
finalmente	Adverb
finché	Konjunktion
fine	Substantiv
finestra	Substantiv
finire	Verb
fino	Präposition
finora	Adverb
finto	Adjektiv
fiore	Substantiv
firma	Substantiv
firmare	Verb
fiume	Substantiv
foglio	Substantiv
folla	Substantiv
fondo	Substantiv
fontana	Substantiv
forchetta	Substantiv
forma	Substantiv
formaggio	Substantiv
formazione	Substantiv
fornello	Substantiv
fornitore	Substantiv
forno	Substantiv
forse	Adverb
forte	Adjektiv
fortuna	Substantiv
forza	Interjektion
forza	Substantiv
fotografia	Substantiv
fra	Präposition
fragile	Adjektiv
francobollo	Substantiv
frase	Substantiv
fratello	Substantiv
freddo	Adjektiv
freddo	Substantiv
freezer	Substantiv
fregarsene	Verb
frenare	Verb
freno	Substantiv
frequentare	Verb
fresco	Adjektiv
fretta	Substantiv
friggere	Verb
frigorifero	Substantiv
fronte	Substantiv
frullatore	Substantiv
frutta	Substantiv
fulmine	Substantiv
fumare	Verb
fumetto	Substantiv
fumo	Substantiv
funzionare	Verb
fuoco	Substantiv
fuori	Adverb
fuori	Präposition
furto	Substantiv
futuro	Substantiv
galera	Substantiv
galleria	Substantiv
gamba	Substantiv
ganzo	Adjektiv
gara	Substantiv
garage	Substantiv
gas	Substantiv
gatto	Substantiv
gelato	Substantiv
gelato	Adjektiv
generalmente	Adverb
generazione	Substantiv
genere	Substantiv
genero	Substantiv
generoso	Adjektiv
genitore	Substantiv
gennaio	Substantiv
gente	Substantiv
gentile	Adjektiv
geografia	Substantiv
gesto	Substantiv
ghiacciaio	Substantiv
ghiaccio	Substantiv
già	Adverb
giacca	Substantiv
giallo	Adjektiv
giardinaggio	Substantiv
giardino	Substantiv
ginnastica	Substantiv
giocare	Verb
giocatore	Substantiv
giocatrice	Substantiv
giocattolo	Substantiv
gioco	Substantiv
gioia	Substantiv
giornale	Substantiv
giornalista	Substantiv
giornata	Substantiv
giorno	Substantiv
giovane	Adjektiv
giovedì	Substantiv
girare	Verb
giro	Substantiv
gita	Substantiv
giù	Adverb
giudice	Substantiv
giugno	Substantiv
giustizia	Substantiv
giusto	Adjektiv
gli	Artikel
gli	Pronomen
globalizzazione	Substantiv
gonna	Substantiv
governo	Substantiv
grado	Substantiv
grammo	Substantiv
grande	Adjektiv
grasso	Adjektiv
gratis	Adverb
grave	Adjektiv
grazie	Interjektion
gridare	Verb
grigio	Adjektiv
grosso	Adjektiv
gruppo	Substantiv
guadagnare	Verb
guanto	Substantiv
guardare	Verb
guarire	Verb
guasto	Adjektiv
guasto	Substantiv
guerra	Substantiv
guida	Substantiv
guidare	Verb
gustare	Verb
gusto	Substantiv
hobby	Substantiv
hotel	Substantiv
i	Artikel
idea	Substantiv
ideale	Adjektiv
identità	Substantiv
ideologia	Substantiv
idraulico	Substantiv
ieri	Adverb
il	Artikel
imitare	Verb
immaginare	Verb
immagine	Substantiv
immobile	Substantiv
imparare	Verb
impaziente	Adjektiv
impegnare	Verb
impegno	Substantiv
impensabile	Adjektiv
impermeabile	Substantiv
impianto	Substantiv
impiegata	Substantiv
impiegato	Substantiv
importante	Adjektiv
importanza	Substantiv
importare	Verb
impossibile	Adjektiv
impresa	Substantiv
impressione	Substantiv
improbabile	Adjektiv
improvvisamente	Adverb
improvviso	Adjektiv
in	Präposition
incendio	Substantiv
incidente	Substantiv
includere	Verb
incominciare	Verb
incontrare	Verb
incontrarsi	Verb
incredibile	Adjektiv
incrocio	Substantiv
incubo	Substantiv
indietro	Adverb
indifferente	Adjektiv
indimenticabile	Adjektiv
indirizzo	Substantiv
indispensabile	Adjektiv
indossare	Verb
industria	Substantiv
infanzia	Substantiv
infatti	Konjunktion
inferiore	Adjektiv
infermiera	Substantiv
infermiere	Substantiv
infine	Adverb
informare	Verb
informazione	Substantiv
ingegnere	Substantiv
iniziare	Verb
inizio	Substantiv
innamorarsi	Verb
innanzitutto	Adverb
innocente	Adjektiv
inoltre	Adverb
inquilina	Substantiv
inquilino	Substantiv
inquinamento	Substantiv
insalata	Substantiv
insegnante	Substantiv
insegnare	Verb
insieme	Adverb
insipido	Adjektiv
insistere	Verb
insomma	Adverb
intanto	Adverb
intelligente	Adjektiv
intendere	Verb
intenzione	Substantiv
interessante	Adjektiv
interessarsi	Verb
interesse	Substantiv
internazionale	Adjektiv
internet	Substantiv
interno	Adjektiv
interno	Substantiv
interrompere	Verb
intervenire	Verb
intervista	Substantiv
intorno	Adverb
introverso	Adjektiv
inutile	Adjektiv
invece	Konjunktion
inventare	Verb
inverno	Substantiv
investire	Verb
inviare	Verb
invisibile	Adjektiv
invitare	Verb
io	Pronomen
iscriversi	Verb
iscrizione	Substantiv
isola	Substantiv
istituto	Substantiv
italiano	Substantiv
la	Artikel
la	Pronomen
là	Adverb
ladra	Substantiv
ladro	Substantiv
laggiù	Adverb
lassù	Adverb
lago	Substantiv
lamentarsi	Verb
lampada	Substantiv
lana	Substantiv
largo	Adjektiv
lasciare	Verb
lato	Substantiv
latte	Substantiv
laurea	Substantiv
laurearsi	Verb
lavagna	Substantiv
lavanderia	Substantiv
lavandino	Substantiv
lavare	Verb
lavarsi	Verb
lavastoviglie	Substantiv
lavatrice	Substantiv
lavorare	Verb
lavorativo	Adjektiv
lavoro	Substantiv
le	Artikel
le	Pronomen
legge	Substantiv
leggere	Verb
leggero	Adjektiv
legno	Substantiv
lei	Pronomen
lentamente	Adverb
lento	Adjektiv
lenzuolo	Substantiv
leone	Substantiv
lettera	Substantiv
letto	Substantiv
lezione	Substantiv
li	Pronomen
lì	Adverb
liberare	Verb
libero	Adjektiv
libertà	Substantiv
libreria	Substantiv
libro	Substantiv
licenziare	Verb
liceo	Substantiv
linea	Substantiv
lingua	Substantiv
liquido	Adjektiv
lirica	Adjektiv
lirica	Substantiv
liscio	Adjektiv
litigare	Verb
litro	Substantiv
livello	Substantiv
lo	Artikel
lo	Pronomen
locale	Substantiv
logico	Adjektiv
lontano	Adjektiv
lontano	Adverb
lordo	Adjektiv
loro	Adjektiv
loro	Pronomen
lotto	Substantiv
luce	Substantiv
luglio	Substantiv
lui	Pronomen
luna	Substantiv
lunedì	Substantiv
lungo	Adjektiv
luogo	Substantiv
lupo	Substantiv
ma	Konjunktion
macchina	Substantiv
madre	Substantiv
maestra	Substantiv
maestro	Substantiv
magari	Interjektion
maggio	Substantiv
maggiore	Adjektiv
maglietta	Substantiv
maglione	Substantiv
magnifico	Adjektiv
magro	Adjektiv
mah	Interjektion
mai	Adverb
maiale	Substantiv
maiuscola	Substantiv
malato	Adjektiv
malattia	Substantiv
male	Adverb
mamma	Substantiv
manager	Substantiv
mancanza	Substantiv
mancare	Verb
mancia	Substantiv
mandare	Verb
mangiare	Verb
manica	Substantiv
maniera	Substantiv
mano	Substantiv
mantenere	Verb
marca	Substantiv
marciapiede	Substantiv
mare	Substantiv
marito	Substantiv
marrone	Adjektiv
martedì	Substantiv
marzo	Substantiv
maschile	Adjektiv
maschio	Substantiv
master	Substantiv
massimo	Adjektiv
matematica	Substantiv
materia	Substantiv
maternità	Substantiv
matita	Substantiv
matrimonio	Substantiv
mattina	Substantiv
matto	Adjektiv
maturità	Substantiv
me	Pronomen
meccanico	Substantiv
medicina	Substantiv
medico	Substantiv
medio	Adjektiv
meglio	Adverb
meglio	Adjektiv
mela	Substantiv
meno	Adverb
mensa	Substantiv
mensile	Substantiv
mensola	Substantiv
mente	Substantiv
mentre	Konjunktion
menù	Substantiv
meraviglioso	Adjektiv
mercato	Substantiv
merce	Substantiv
mercoledì	Substantiv
merenda	Substantiv
mese	Substantiv
messa	Substantiv
messaggio	Substantiv
metà	Substantiv
metallo	Substantiv
metodo	Substantiv
metro	Substantiv
metropoli	Substantiv
metro	Substantiv
metro	Substantiv
metropolitana	Substantiv
mettercela	Verb
mettere	Verb
mettersi	Verb
mezzanotte	Substantiv
mezzo	Substantiv
mezzo	Adjektiv
mezzogiorno	Substantiv
mi	Pronomen
migliorare	Verb
migliore	Adjektiv
militare	Adjektiv
militare	Substantiv
millimetro	Substantiv
minestra	Substantiv
minimo	Adjektiv
ministro	Substantiv
minore	Adjektiv
minuscola	Substantiv
minuscolo	Adjektiv
minuto	Substantiv
mio	Adjektiv
mio	Pronomen
miseria	Substantiv
mite	Adjektiv
mittente	Substantiv
mobile	Substantiv
moda	Substantiv
moderno	Adjektiv
modo	Substantiv
modulo	Substantiv
moglie	Substantiv
moltiplicare	Verb
molto	Adjektiv
momento	Substantiv
mondo	Substantiv
moneta	Substantiv
monolocale	Substantiv
montagna	Substantiv
monumento	Substantiv
morbido	Adjektiv
morire	Verb
morte	Substantiv
mostra	Substantiv
mostrare	Verb
motivo	Substantiv
moto	Substantiv
motocicletta	Substantiv
motore	Substantiv
motorino	Substantiv
movimento	Substantiv
mucca	Substantiv
multa	Substantiv
municipio	Substantiv
muovere	Verb
muoversi	Verb
mura	Substantiv
muro	Substantiv
museo	Substantiv
musica	Substantiv
musicale	Adjektiv
muto	Adjektiv
mutuo	Substantiv
nascere	Verb
nascondere	Verb
naso	Substantiv
Natale	Substantiv
natura	Substantiv
naturale	Adjektiv
nave	Substantiv
navigare	Verb
nazionalità	Substantiv
nazione	Substantiv
ne	Pronominalpartikel
né	Konjunktion
neanche	Adverb
neanche	Konjunktion
nebbia	Substantiv
necessario	Adjektiv
negativo	Adjektiv
negozio	Substantiv
nemico	Adjektiv
nemico	Substantiv
nemmeno	Adverb
nemmeno	Konjunktion
nero	Adjektiv
nervoso	Adjektiv
nessuno	Adjektiv
nessuno	Pronomen
netto	Adjektiv
neve	Substantiv
nevicare	Verb
niente	Pronomen
niente	Adverb
nipote	Substantiv
no	Adverb
noi	Pronomen
noioso	Adjektiv
noleggiare	Verb
nome	Substantiv
non	Adverb
nonna	Substantiv
nonno	Substantiv
nonostante	Präposition
nonostante	Konjunktion
nord	Substantiv
normale	Adjektiv
nostalgia	Substantiv
nostro	Adjektiv
nostro	Pronomen
notizia	Substantiv
notte	Substantiv
novembre	Substantiv
novità	Substantiv
nubile	Adjektiv
nulla	Adverb
numero	Substantiv
nuora	Substantiv
nuotare	Verb
nuoto	Substantiv
nuovo	Adjektiv
nuvola	Substantiv
nuvoloso	Adjektiv
o	Konjunktion
obbligare	Verb
obbligatorio	Adjektiv
occasione	Substantiv
occhiale	Substantiv
occhio	Substantiv
occupare	Verb
occuparsi	Verb
odiare	Verb
odio	Substantiv
odore	Substantiv
offerta	Substantiv
offrire	Verb
oggetto	Substantiv
oggi	Adverb
oggigiorno	Adverb
ogni	Adjektiv
ognuno	Pronomen
ok	Interjektion
olio	Substantiv
ombrello	Substantiv
omicidio	Substantiv
onestà	Substantiv
onesto	Adjektiv
opera	Substantiv
operaia	Substantiv
operaio	Substantiv
opinione	Substantiv
opportunità	Substantiv
opportuno	Adjektiv
oppure	Konjunktion
ora	Substantiv
ora	Adverb
orario	Substantiv
ordinare	Verb
ordine	Substantiv
orecchio	Substantiv
organizzare	Verb
organizzazione	Substantiv
orizzontale	Adjektiv
ormai	Adverb
oro	Substantiv
orologio	Substantiv
orribile	Adjektiv
ospedale	Substantiv
ospitalità	Substantiv
ospite	Substantiv
osservare	Verb
ottimista	Adjektiv
ottimo	Adjektiv
ottobre	Substantiv
ovale	Adjektiv
ovest	Substantiv
ovvio	Adjektiv
pacco	Substantiv
pace	Substantiv
padella	Substantiv
padre	Substantiv
padrona	Substantiv
padrone	Substantiv
paesaggio	Substantiv
paese	Substantiv
paga	Substantiv
pagamento	Substantiv
pagare	Verb
pagina	Substantiv
paio	Substantiv
palazzo	Substantiv
palestra	Substantiv
palla	Substantiv
pallacanestro	Substantiv
pane	Substantiv
panino	Substantiv
pantalone	Substantiv
Papa	Substantiv
papà	Substantiv
parcheggio	Substantiv
parco	Substantiv
parecchio	Adverb
parecchio	Adjektiv
parente	Substantiv
parentesi	Substantiv
parere	Substantiv
parete	Substantiv
parlamento	Substantiv
parlare	Verb
parola	Substantiv
parte	Substantiv
partecipare	Verb
partenza	Substantiv
particolarmente	Adverb
partire	Verb
partita	Substantiv
partito	Substantiv
Pasqua	Substantiv
passaggio	Substantiv
passaporto	Substantiv
passare	Verb
passato	Substantiv
passeggiare	Verb
passeggiata	Substantiv
passione	Substantiv
pasta	Substantiv
pasto	Substantiv
patata	Substantiv
patente	Substantiv
patto	Substantiv
paura	Substantiv
pausa	Substantiv
pavimento	Substantiv
pazienza	Substantiv
pazzesco	Adjektiv
peccato	Substantiv
pediatra	Substantiv
pedonale	Adjektiv
peggio	Adverb
peggio	Adjektiv
peggiorare	Verb
peggiore	Adjektiv
pelle	Substantiv
pena	Substantiv
penna	Substantiv
pensare	Verb
pensione	Substantiv
pentola	Substantiv
pepe	Substantiv
per	Präposition
pera	Substantiv
perché	Adverb
perché	Konjunktion
perciò	Konjunktion
perdere	Verb
perdonare	Verb
perfetto	Adjektiv
perfino	Adverb
pericoloso	Adjektiv
periferia	Substantiv
periodo	Substantiv
permesso	Substantiv
però	Konjunktion
persona	Substantiv
personaggio	Substantiv
personale	Adjektiv
personale	Substantiv
personalità	Substantiv
personalmente	Adverb
pesante	Adjektiv
pesare	Verb
pescare	Verb
pesce	Substantiv
pessimista	Adjektiv
pessimo	Adjektiv
pettine	Substantiv
pezzo	Substantiv
phon	Substantiv
piacere	Substantiv
piacevole	Adjektiv
piangere	Verb
piano	Adverb
piano	Substantiv
pianta	Substantiv
piatto	Substantiv
piazza	Substantiv
piccante	Adjektiv
piccolo	Adjektiv
piede	Substantiv
piegare	Verb
piegarsi	Verb
pieno	Adjektiv
pieno	Substantiv
pietà	Substantiv
pigro	Adjektiv
pillola	Substantiv
pioggia	Substantiv
piovere	Verb
pipa	Substantiv
piscina	Substantiv
pisello	Substantiv
pistola	Substantiv
pittore	Substantiv
pittrice	Substantiv
pittura	Substantiv
più	Adverb
piuttosto	Adverb
pizza	Substantiv
pizzeria	Substantiv
pizzico	Substantiv
plastica	Substantiv
plurale	Adjektiv
plurale	Substantiv
po’	Adverb
poco	Adjektiv
poco	Adverb
poesia	Substantiv
poeta	Substantiv
poetessa	Substantiv
poi	Adverb
poiché	Konjunktion
politica	Substantiv
politico	Adjektiv
polizia	Substantiv
polizza	Substantiv
pollo	Substantiv
poltrona	Substantiv
pomeriggio	Substantiv
pomodoro	Substantiv
pompiere	Substantiv
ponte	Substantiv
pop	Substantiv
pop	Adjektiv
porco	Adjektiv
porgere	Verb
porta	Substantiv
portare	Verb
porto	Substantiv
posacenere	Substantiv
posata	Substantiv
positivo	Adjektiv
possedere	Verb
possibile	Adjektiv
possibilità	Substantiv
posta	Substantiv
postino	Substantiv
posto	Substantiv
potere	Verb
povero	Adjektiv
povertà	Substantiv
pranzare	Verb
pranzo	Substantiv
praticamente	Adverb
pratico	Adjektiv
prato	Substantiv
precedente	Adjektiv
precedenza	Substantiv
preferire	Verb
prefisso	Substantiv
pregare	Verb
prego	Interjektion
premere	Verb
prendere	Verb
prendersela	Verb
prenotare	Verb
preoccuparsi	Verb
preoccupazione	Substantiv
preparare	Verb
preposizione	Substantiv
presentare	Verb
presentazione	Substantiv
presente	Adjektiv
presenza	Substantiv
preside	Substantiv
presidente	Substantiv
presso	Adverb
prestare	Verb
prestito	Substantiv
presto	Adverb
prete	Substantiv
previsione	Substantiv
prezzemolo	Substantiv
prezzo	Substantiv
prigione	Substantiv
prima	Adverb
primavera	Substantiv
primo	Adjektiv
primo	Substantiv
principale	Substantiv
privato	Adjektiv
probabile	Adjektiv
probabilità	Substantiv
probabilmente	Adverb
problema	Substantiv
processo	Substantiv
prodotto	Substantiv
professore	Substantiv
professoressa	Substantiv
profondo	Adjektiv
profumo	Substantiv
progetto	Substantiv
programma	Substantiv
proibire	Verb
promettere	Verb
promuovere	Verb
pronome	Substantiv
pronto	Adjektiv
pronuncia	Substantiv
proporre	Verb
proposito	Substantiv
proprio	Adjektiv
proprio	Adverb
prosciutto	Substantiv
prossimo	Adjektiv
protagonista	Substantiv
proteggere	Verb
provare	Verb
Provincia	Substantiv
pubblicità	Substantiv
pubblico	Adjektiv
pulire	Verb
pulizia	Substantiv
punto	Substantiv
purché	Konjunktion
pure	Adverb
pure	Konjunktion
puro	Adjektiv
purtroppo	Adverb
puzza	Substantiv
puzzare	Verb
qua	Adverb
quaderno	Substantiv
quadrato	Adjektiv
quadro	Substantiv
quadro	Adjektiv
qualche	Adjektiv
qualcosa	Pronomen
qualcuno	Pronomen
quale	Pronomen
quale	Adjektiv
qualità	Substantiv
qualsiasi	Pronomen
qualsiasi	Adjektiv
qualunque	Adjektiv
quando	Konjunktion
quando	Adverb
quanto	Adjektiv
quanto	Adverb
quartiere	Substantiv
quarto	Substantiv
quasi	Adverb
quello	Adjektiv	
quello	Pronomen
questione	Substantiv
questo	Adjektiv
questo	Pronomen
questura	Substantiv
qui	Adverb
quindi	Adverb
quindi	Konjunktion
quintale	Substantiv
quotidiano	Substantiv
racchetta	Substantiv
raccogliere	Verb
raccomandarsi	Verb
raccomandata	Substantiv
raccontare	Verb
radio	Substantiv
raffreddore	Substantiv
ragazza	Substantiv
ragazzo	Substantiv
raggiungere	Verb
ragione	Substantiv
rallentare	Verb
rapina	Substantiv
rapporto	Substantiv
raramente	Adverb
rata	Substantiv
reagire	Verb
realizzare	Verb
realtà	Substantiv
reclamo	Substantiv
regalare	Verb
regalo	Substantiv
Regione	Substantiv
regista	Substantiv
regola	Substantiv
relazione	Substantiv
religioso	Adjektiv
rendere	Verb
reparto	Substantiv
repubblica	Substantiv
residenza	Substantiv
responsabile	Adjektiv
responsabile	Substantiv
responsabilità	Substantiv
restare	Verb
restituire	Verb
resto	Substantiv
rettangolare	Adjektiv
rettore	Substantiv
riassumere	Verb
ricchezza	Substantiv
riccio	Adjektiv
ricco	Adjektiv
ricerca	Substantiv
ricetta	Substantiv
ricevere	Verb
ricevuta	Substantiv
riconoscere	Verb
ricordare	Verb
ricordarsi	Verb
ricordo	Substantiv
ridere	Verb
ridicolo	Adjektiv
riferire	Verb
riferirsi	Verb
rifiutare	Verb
riflettere	Verb
riguardare	Verb
rilassarsi	Verb
rimanere	Verb
rimettersi	Verb
ringraziare	Verb
rinunciare	Verb
riparare	Verb
ripetere	Verb
riposare	Verb
riposarsi	Verb
riprendere	Verb
riprendersi	Verb
riscaldamento	Substantiv
rischioso	Adjektiv
riscontro	Substantiv
riso	Substantiv
risolvere	Verb
risparmiare	Verb
rispettare	Verb
rispetto	Substantiv
rispondere	Verb
risposta	Substantiv
ristorante	Substantiv
risultato	Substantiv
ritardo	Substantiv
ritirare	Verb
ritornare	Verb
ritrovare	Verb
riuscire	Verb
rivista	Substantiv
roba	Substantiv
rock	Substantiv
romantico	Adjektiv
romanzo	Substantiv
rompere	Verb
rompersi	Verb
rosa	Adjektiv
rosso	Adjektiv
rotatoria	Substantiv
rotondo	Adjektiv
roulotte	Substantiv
rubare	Verb
rumore	Substantiv
ruota	Substantiv
ruvido	Adjektiv
sabato	Substantiv
sacco	Substantiv
saggio	Substantiv
sala	Substantiv
salame	Substantiv
salato	Adjektiv
saldo	Substantiv
sale	Substantiv
salire	Verb
salita	Substantiv
salotto	Substantiv
salsa	Substantiv
saltare	Verb
salutare	Verb
salute	Substantiv
salute	Interjektion
saluto	Substantiv
salvare	Verb
salve	Interjektion
sandalo	Substantiv
sano	Adjektiv
santo	Adjektiv
santo	Substantiv
sapere	Verb
sapone	Substantiv
sapore	Substantiv
sbagliare	Verb
sbagliarsi	Verb
sbaglio	Substantiv
sbucciare	Verb
scaffale	Substantiv
scala	Substantiv
scaricare	Verb
scarpa	Substantiv
scegliere	Verb
scendere	Verb
scherzare	Verb
schiera	Substantiv
schifo	Substantiv
sci	Substantiv
sciare	Verb
scienza	Substantiv
sciopero	Substantiv
sciroppo	Substantiv
scomodo	Adjektiv
sconfiggere	Verb
sconto	Substantiv
scontrino	Substantiv
scopo	Substantiv
scoprire	Verb
scorretto	Adjektiv
scorso	Adjektiv
scrittore	Substantiv
scrittrice	Substantiv
scrivania	Substantiv
scrivere	Verb
scultore	Substantiv
scultrice	Substantiv
scultura	Substantiv
scuola	Substantiv
scuro	Adjektiv
scusa	Substantiv
scusare	Verb
sdraiare	Verb
sdraiarsi	Verb
se	Konjunktion
sé	Pronomen
sebbene	Konjunktion
secco	Adjektiv
secolo	Substantiv
secondo	Substantiv
secondo	Präposition
secondo	Adjektiv
sede	Substantiv
sedersi	Verb
sedia	Substantiv
segretaria	Substantiv
segretario	Substantiv
segreteria	Substantiv
seguente	Adjektiv
seguire	Verb
seguito	Substantiv
semaforo	Substantiv
sembrare	Verb
semplice	Adjektiv
sempre	Adverb
senato	Substantiv
sennò	Konjunktion
sensazione	Substantiv
senso	Substantiv
sentimento	Substantiv
sentire	Verb
sentirsi	Verb
senza	Präposition
separare	Verb
separarsi	Verb
sera	Substantiv
serata	Substantiv
sereno	Adjektiv
serio	Adjektiv
servire	Verb
servizio	Substantiv
sesso	Substantiv
seta	Substantiv
sete	Substantiv
settembre	Substantiv
settimana	Substantiv
settimanale	Substantiv
sfortuna	Substantiv
sfruttare	Verb
shampoo	Substantiv
si	Pronomen
sì	Adverb
sia	Konjunktion
siccome	Konjunktion
sicuramente	Adverb
sicurezza	Substantiv
sicuro	Adjektiv
sigaretta	Substantiv
sigaro	Substantiv
significare	Verb
significato	Substantiv
signora	Substantiv
signore	Substantiv
silenzio	Substantiv
sillaba	Substantiv
simile	Adjektiv
simpatico	Adjektiv
sindacato	Substantiv
sindaco	Substantiv
singolare	Adjektiv
singolo	Adjektiv
sinistra	Substantiv
sistema	Substantiv
sito	Substantiv
situazione	Substantiv
smettere	Verb
sms	Substantiv
soccorso	Substantiv
sociale	Adjektiv
società	Substantiv
socievole	Adjektiv
socia	Substantiv
socio	Substantiv
soddisfatto	Adjektiv
soffitto	Substantiv
soffrire	Verb
soggetto	Substantiv
soggiorno	Substantiv
sognare	Verb
sogno	Substantiv
soldatessa	Substantiv
soldato	Substantiv
soldo	Substantiv
sole	Substantiv
solido	Adjektiv
solito	Adjektiv
solitudine	Substantiv
sollecito	Adjektiv
solo	Adjektiv
solo	Adverb
soltanto	Adverb
soluzione	Substantiv
somma	Substantiv
sonno	Substantiv
sopra	Präposition
sopra	Adverb
soprattutto	Adverb
sopravvivere	Verb
sordo	Adjektiv
sorella	Substantiv
sorpresa	Substantiv
sorridere	Verb
sospendere	Verb
sottile	Adjektiv
sotto	Präposition
sotto	Adverb
sottolineare	Verb
sottrarre	Verb
spaghetto	Substantiv
sparare	Verb
spaventare	Verb
spaventoso	Adjektiv
spazio	Substantiv
spazzolino	Substantiv
specchio	Substantiv
speciale	Adjektiv
specializzarsi	Verb
specializzazione	Substantiv
specialmente	Adverb
spedire	Verb
spegnere	Verb
spendere	Verb
sperare	Verb
spesa	Substantiv
spesso	Adverb
spesso	Adjektiv
spettabile	Adjektiv
spettacolo	Substantiv
spiaggia	Substantiv
spicchio	Substantiv
spiegare	Verb
spiegarsi	Verb
spingere	Verb
spogliarsi	Verb
sporcare	Verb
sporco	Adjektiv
sport	Substantiv
sportivo	Adjektiv
sposare	Verb
sposarsi	Verb
spostare	Verb
spuntino	Substantiv
squadra	Substantiv
stadio	Substantiv
stage	Substantiv
stamattina	Adverb
stampare	Verb
stanco	Adjektiv
stanotte	Adverb
stanza	Substantiv
stare	Verb
stasera	Adverb
statale	Adjektiv
stato	Substantiv
stazione	Substantiv
stella	Substantiv
stendere	Verb
stendersi	Verb
stesso	Adjektiv
stesso	Pronomen
stile	Substantiv
stipendio	Substantiv
stirare	Verb
stiro	Substantiv
stivale	Substantiv
stomaco	Substantiv
stop	Substantiv
storia	Substantiv
storico	Adjektiv
strada	Substantiv
straniero	Adjektiv
strano	Adjektiv
stress	Substantiv
stressare	Verb
stretto	Adjektiv
studente	Substantiv
studentessa	Substantiv
studiare	Verb
studio	Substantiv
su	Präposition
su	Adverb
subito	Adverb
succedere	Verb
successo	Substantiv
sud	Substantiv
suo	Adjektiv
suo	Pronomen
suocera	Substantiv
suocero	Substantiv
suonare	Verb
suora	Substantiv
superare	Verb
superiore	Adjektiv
supermercato	Substantiv
svantaggio	Substantiv
svegliare	Verb
svegliarsi	Verb
sviluppare	Verb
sviluppo	Substantiv
svolgere	Verb
tabaccaio	Substantiv
tagliare	Verb
tale	Adjektiv
talk-show	Substantiv
talvolta	Adverb
tanto	Pronomen
tanto	Adjektiv
tappeto	Substantiv
tardi	Adverb
tariffa	Substantiv
tasca	Substantiv
tassa	Substantiv
tavola	Substantiv
tavolo	Substantiv
taxi	Substantiv
tazza	Substantiv
te	Pronomen
tè	Substantiv
teatro	Substantiv
tecnico	Substantiv
tecnologia	Substantiv
telefilm	Substantiv
telefonare	Verb
telefonata	Substantiv
telefono	Substantiv
telegiornale	Substantiv
telegramma	Substantiv
televisione	Substantiv
temere	Verb
temperatura	Substantiv
tempo	Substantiv
temporale	Substantiv
tenda	Substantiv
tenere	Verb
tenero	Adjektiv
tennis	Substantiv
tensione	Substantiv
teoria	Substantiv
terapia	Substantiv
terminare	Verb
termometro	Substantiv
termosifone	Substantiv
terra	Substantiv
terrazza	Substantiv
terribile	Adjektiv
terrorismo	Substantiv
terrorizzare	Verb
testa	Substantiv
testo	Substantiv
tetto	Substantiv
ti	Pronomen
tiepido	Adjektiv
tigre	Substantiv
timido	Adjektiv
tipico	Adjektiv
tipo	Substantiv
tirare	Verb
titolo	Substantiv
toccare	Verb
togliere	Verb
tombola	Substantiv
tonnellata	Substantiv
tornare	Verb
torre	Substantiv
torta	Substantiv
tortellino	Substantiv
torto	Substantiv
tosse	Substantiv
tostapane	Substantiv
totale	Substantiv
tovaglia	Substantiv
tovagliolo	Substantiv
tra	Präposition
tradizionale	Adjektiv
tradurre	Verb
traffico	Substantiv
tragedia	Substantiv
tramonto	Substantiv
tranquillità	Substantiv
tranquillo	Adjektiv
trascorrere	Verb
trasferirsi	Verb
trasformare	Verb
traslocare	Verb
trasloco	Substantiv
trasmissione	Substantiv
trasparente	Adjektiv
trasportare	Verb
trattare	Verb
tratto	Substantiv
treno	Substantiv
tribunale	Substantiv
triste	Adjektiv
troppo	Adjektiv
trovare	Verb
trovarsi	Verb
tu	Pronomen
tuo	Adjektiv
tuo	Pronomen
tuono	Substantiv
turismo	Substantiv
turista	Substantiv
tuttavia	Konjunktion
tutto	Adjektiv
tv	Substantiv
ubriacarsi	Verb
ubriaco	Adjektiv
uccello	Substantiv
uccidere	Verb
uffa	Interjektion
ufficio	Substantiv
uguale	Adjektiv
ulteriore	Adjektiv
ultimo	Adjektiv
umido	Adjektiv
umore	Substantiv
un	Artikel
un	Pronomen
una	Artikel
una	Pronomen
uno	Artikel
uno	Pronomen
unico	Adjektiv
università	Substantiv
uomo	Substantiv
uovo	Substantiv
urgente	Adjektiv
usare	Verb
uscire	Verb
uscita	Substantiv
utile	Adjektiv
utilizzare	Verb
vacanza	Substantiv
vaglia	Substantiv
vagone	Substantiv
valere	Verb
valigia	Substantiv
valore	Substantiv
vantaggio	Substantiv
variabile	Adjektiv
vario	Adjektiv
vasca	Substantiv
vaso	Substantiv
vecchio	Adjektiv
vedere	Verb
vedersi	Verb
vedovo	Adjektiv
vegetariano	Adjektiv
veloce	Adjektiv
velocemente	Adverb
velocità	Substantiv
vendere	Verb
venerdì	Substantiv
venire	Verb
vento	Substantiv
veramente	Adverb
verbo	Substantiv
verde	Adjektiv
verdura	Substantiv
vergognarsi	Verb
verità	Substantiv
vero	Adjektiv
versare	Verb
verso	Präposition
verticale	Adjektiv
vestirsi	Verb
vestito	Substantiv
vetrina	Substantiv
vetro	Substantiv
vi	Pronomen
via	Substantiv
via	Adverb
viaggiare	Verb
viaggio	Substantiv
vicino	Adverb
vietare	Verb
vigile	Substantiv
vigilessa	Substantiv
villa	Substantiv
villaggio	Substantiv
vincere	Verb
vino	Substantiv
viola	Adjektiv
violenza	Substantiv
virgola	Substantiv
virgoletta	Substantiv
visitare	Verb
viso	Substantiv
vista	Substantiv
visto	Substantiv
vita	Substantiv
vivere	Verb
vivo	Adjektiv
vocale	Substantiv
voce	Substantiv
voglia	Substantiv
voi	Pronomen
volare	Verb
volentieri	Adverb
volere	Verb
volontà	Substantiv
volta	Substantiv
vostro	Adjektiv
vostro	Pronomen
votare	Verb
vuoto	Adjektiv
water	Substantiv
zaino	Substantiv
zia	Substantiv
zio	Substantiv
zucchero	Substantiv


