aceto	Maskulin	aceti
acqua	Feminin	acque
aereo	Maskulin	aerei
aeroplano	Maskulin	aeroplani
aeroporto	Maskulin	aeroporti
affetto	Maskulin	affetti
agenzia	Feminin	agenzie
agosto	Maskulin	/
albergo	Maskulin	alberghi
albero	Maskulin	alberi
alfabeto	Maskulin	alfabeti
ambasciata	Feminin	ambasciate
amica	Feminin	amiche
amico	Maskulin	amici
amore	Maskulin	amori
animale	Maskulin	animali
anno	Maskulin	anni
appartamento	Maskulin	appartamenti
appuntamento	Maskulin	appuntamenti
aprile	Maskulin	/
arte	Feminin	arti
attenzione	Feminin	attenzioni
augurio	Maskulin	auguri
autobus	Maskulin	autobus
autunno	Maskulin	autunni
bacio	Maskulin	baci
bagno	Maskulin	bagni
bambina	Feminin	bambine
bambino	Maskulin	bambini
banca	Feminin	banche
bar	Maskulin	bar
bicchiere	Maskulin	bicchieri
bici	Feminin	bici
bicicletta	Feminin	biciclette
biglietto	Maskulin	biglietti
birra	Feminin	birre
borsa	Feminin	borse
bottiglia	Feminin	bottiglie
busta	Feminin	buste
caffè	Maskulin	caffè
calza	Feminin	calze
camera	Feminin	camere
cameriera	Feminin	cameriere
cameriere	Maskulin	camerieri
camicia	Feminin	camicie
campagna	Feminin	campagne
cane	Maskulin	cani
canzone	Feminin	canzoni
capello	Maskulin	capelli
cappotto	Maskulin	cappotti
cappuccino	Maskulin	cappuccini
carne	Feminin	carni
carta	Feminin	carte
cartolina	Feminin	cartoline
casa	Feminin	case
cd	Maskulin	cd
cellulare	Maskulin	cellulari
cena	Feminin	cene
centro	Maskulin	centri
check-in	Maskulin	check-in
chiave	Feminin	chiavi
chiesa	Feminin	chiese
cibo	Maskulin	cibi
cinema	Maskulin	cinema
città	Feminin	città
classe	Feminin	classi
cognome	Maskulin	cognomi
colazione	Feminin	colazioni
colore	Maskulin	colori
coltello	Maskulin	coltelli
compagna	Feminin	compagne
compagno	Maskulin	compagni
compleanno	Maskulin	compleanni
computer	Maskulin	computer
consolato	Maskulin	consolati
conto	Maskulin	conti
corso	Maskulin	corsi
cosa	Feminin	cose
credito	Maskulin	crediti
cucchiaio	Maskulin	cucchiai
cucina	Feminin	cucine
data	Feminin	date
destra	Feminin	destre
dicembre	Maskulin	/
doccia	Feminin	docce
documento	Maskulin	documenti
domanda	Feminin	domande
domenica	Feminin	domeniche
donna	Feminin	donne
dottore	Maskulin	dottori
dottoressa	Feminin	dottoresse
e-mail	Feminin	e-mail
esercizio	Maskulin	esercizi
estate	Feminin	estati
estero	Maskulin	esteri
euro	Maskulin	/
fabbrica	Feminin	fabbriche
fame	Feminin	/
famiglia	Feminin	famiglie
farmacia	Feminin	farmacie
favore	Maskulin	favori
fax	Maskulin	fax
febbraio	Maskulin	/
femmina	Feminin	femmine
fermata	Feminin	fermate
festa	Feminin	feste
figlia	Feminin	figlie
figlio	Maskulin	figli
film	Maskulin	film
finestra	Feminin	finestre
fiore	Maskulin	fiori
forchetta	Feminin	forchette
fotografia	Feminin	fotografie
francobollo	Maskulin	francobolli
fratello	Maskulin	fratelli
frutta	Feminin	frutta
gatto	Maskulin	gatti
gennaio	Maskulin	/
giacca	Feminin	giacche
giardino	Maskulin	giardini
giornale	Maskulin	giornali
giornata	Feminin	giornate
giorno	Maskulin	giorni
giovedì	Maskulin	giovedì
giugno	Maskulin	/
gonna	Feminin	gonne
hobby	Maskulin	hobby
hotel	Maskulin	hotel
indirizzo	Maskulin	indirizzi
industria	Feminin	industrie
informazione	Feminin	informazioni
insegnante	Maskulin,Feminin	insegnanti
internet	Feminin	/
inverno	Maskulin	inverni
italiano	Maskulin	italiani
lago	Maskulin	laghi
latte	Maskulin	latti
lavoro	Maskulin	lavori
lettera	Feminin	lettere
letto	Maskulin	letti
lezione	Feminin	lezioni
libro	Maskulin	libri
lingua	Feminin	lingue
luglio	Maskulin	/
lunedì	Maskulin	lunedì
macchina	Feminin	macchine
madre	Feminin	madri
maggio	Maskulin	/
maglietta	Feminin	magliette
maglione	Maskulin	maglioni
mamma	Feminin	mamme
mare	Maskulin	mari
marito	Maskulin	mariti
martedì	Maskulin	martedì
marzo	Maskulin	/
maschio	Maskulin	maschi
matita	Feminin	matite
mattina	Feminin	mattine
medicina	Feminin	medicine
menù	Maskulin	menù
mercato	Maskulin	mercati
mercoledì	Maskulin	mercoledì
mese	Maskulin	mesi
metà	Feminin	metà
mezzanotte	Feminin	mezzanotti
mezzogiorno	Maskulin	mezzogiorni
minuto	Maskulin	minuti
moglie	Feminin	mogli
momento	Maskulin	momenti
montagna	Feminin	montagne
moto	Feminin	moto
motocicletta	Feminin	motociclette
museo	Maskulin	musei
musica	Feminin	musiche
Natale	Maskulin	Natali
nazionalità	Feminin	nazionalità
nazione	Feminin	nazioni
negozio	Maskulin	negozi
nome	Maskulin	nomi
nonna	Feminin	nonne
nonno	Maskulin	nonni
notte	Feminin	notti
novembre	Maskulin	/
numero	Maskulin	numeri
occhiale	Maskulin	occhiali
olio	Maskulin	oli
ombrello	Maskulin	ombrelli
ora	Feminin	ore
orologio	Maskulin	orologi
ospedale	Maskulin	ospedali
ottobre	Maskulin	/
pacco	Maskulin	pacchi
padre	Maskulin	padri
pane	Maskulin	pani
pantalone	Maskulin	pantaloni
papà	Maskulin	papà
parcheggio	Maskulin	parcheggi
parco	Maskulin	parchi
parola	Feminin	parole
Pasqua	Feminin	Pasque
passaporto	Maskulin	passaporti
pasta	Feminin	paste
penna	Feminin	penne
pepe	Maskulin	pepi
pesce	Maskulin	pesci
piacere	Maskulin	piaceri
piano	Maskulin	piani
pianta	Feminin	piante
piatto	Maskulin	piatti
piazza	Feminin	piazze
pizza	Feminin	pizze
pizzeria	Feminin	pizzerie
polizia	Feminin	polizie
pomeriggio	Maskulin	pomeriggi
pomodoro	Maskulin	pomodori
porta	Feminin	porte
posta	Feminin	poste
posto	Maskulin	posti
pranzo	Maskulin	pranzi
prezzo	Maskulin	prezzi
primavera	Feminin	primavere
professore	Maskulin	professori
professoressa	Feminin	professoresse
quaderno	Maskulin	quaderni
quadro	Maskulin	quadri
quarto	Maskulin	quarti
radio	Feminin	radio
ragazza	Feminin	ragazze
ragazzo	Maskulin	ragazzi
riso	Maskulin	risi
risposta	Feminin	risposte
ristorante	Maskulin	ristoranti
sabato	Maskulin	sabati
sale	Maskulin	sali
saluto	Maskulin	saluti
scarpa	Feminin	scarpe
scuola	Feminin	scuole
secondo	Maskulin	secondi
sedia	Feminin	sedie
segreteria	Feminin	segreterie
sera	Feminin	sere
sete	Feminin	/
settembre	Maskulin	/
settimana	Feminin	settimane
sigaretta	Feminin	sigarette
signora	Feminin	signore
signore	Maskulin	signori
sinistra	Feminin	sinistre
soggiorno	Maskulin	soggiorni
soldo	Maskulin	soldi
sole	Maskulin	soli
sonno	Maskulin	sonni
sorella	Feminin	sorelle
spaghetto	Maskulin	spaghetti
spesa	Feminin	spese
spiaggia	Feminin	spiagge
sport	Maskulin	sport
stazione	Feminin	stazioni
stop	Maskulin	stop
strada	Feminin	strade
studente	Maskulin	studenti
studentessa	Feminin	studentesse
supermercato	Maskulin	supermercati
tavolo	Maskulin	tavoli
taxi	Maskulin	taxi
tè	Maskulin	tè
teatro	Maskulin	teatri
telefono	Maskulin	telefoni
televisione	Feminin	televisioni
treno	Maskulin	treni
turista	Maskulin,Feminin	turisti,turiste
tv	Feminin	tv
ufficio	Maskulin	uffici
università	Feminin	università
uomo	Maskulin	uomini
uovo	Maskulin	uova(F)
vacanza	Feminin	vacanze
valigia	Feminin	valigie
venerdì	Maskulin	venerdì
verdura	Feminin	verdure
vestito	Maskulin	vestiti
via	Feminin	vie
viaggio	Maskulin	viaggi
vino	Maskulin	vini
visto	Maskulin	visti
zaino	Maskulin	zaini
zucchero	Maskulin	zuccheri
abbonamento	Maskulin	abbonamenti
abbraccio	Maskulin	abbracci
accendino	Maskulin	accendini
accordo	Maskulin	accordi
adulta	Feminin	adulte
adulto	Maskulin	adulti
affitto	Maskulin	affitti
aiuto	Maskulin	aiuti
alimentari	Maskulin	alimentari
anello	Maskulin	anelli
anticipo	Maskulin	anticipi
antipasto	Maskulin	antipasti
anziana	Feminin	anziane
anziano	Maskulin	anziani
aperitivo	Maskulin	aperitivi
appetito	Maskulin	appetiti
arancia	Feminin	arance
argento	Maskulin	argenti
aria	Feminin	arie
armadio	Maskulin	armadi
arrivo	Maskulin	arrivi
arrosto	Maskulin	arrosti
articolo	Maskulin	articoli
ascensore	Maskulin	ascensori
asciugamano	Maskulin	asciugamani
aula	Feminin	aule
auto	Feminin	auto
automobile	Feminin	automobili
autostrada	Feminin	autostrade
baffo	Maskulin	baffi
balcone	Maskulin	balconi
bambola	Feminin	bambole
banana	Feminin	banane
banco	Maskulin	banchi
barba	Feminin	barbe
barca	Feminin	barche
benzina	Feminin	benzine
bibita	Feminin	bibite
biblioteca	Feminin	biblioteche
biglietteria	Feminin	biglietterie
bisogno	Maskulin	bisogni
bistecca	Feminin	bistecche
bocca	Feminin	bocche
bosco	Maskulin	boschi
braccio	Maskulin	bracci(M),braccia(F)
buio	Maskulin	bui
burro	Maskulin	burri
calcio	Maskulin	calci
caldo	Maskulin	caldi
campeggio	Maskulin	campeggi
camper	Maskulin	camper
cantina	Feminin	cantine
capo	Maskulin	capi
cappello	Maskulin	cappelli
carota	Feminin	carote
casalinga	Feminin	casalinghe
casalingo	Maskulin	casalinghi
cassa	Feminin	casse
cavallo	Maskulin	cavalli
centimetro	Maskulin	centimetri
chilo	Maskulin	chili
chilometro	Maskulin	chilometri
cielo	Maskulin	cieli
cioccolato	Maskulin	cioccolati
cognata	Feminin	cognate
cognato	Maskulin	cognati
collana	Feminin	collane
collega	Maskulin,Feminin	colleghi,colleghe
collina	Feminin	colline
commessa	Feminin	commesse
commesso	Maskulin	commessi
comodino	Maskulin	comodini
compito	Maskulin	compiti
complimento	Maskulin	complimenti
concerto	Maskulin	concerti
confine	Maskulin	confini
congratulazione	Feminin	congratulazioni
contorno	Maskulin	contorni
conversazione	Feminin	conversazioni
coperta	Feminin	coperte
coppia	Feminin	coppie
corpo	Maskulin	corpi
costo	Maskulin	costi
cotone	Maskulin	cotoni
crema	Feminin	creme
crociera	Feminin	crociere
cugina	Feminin	cugine
cugino	Maskulin	cugini
cultura	Feminin	culture
cuscino	Maskulin	cuscini
dente	Maskulin	denti
dentifricio	Maskulin	dentifrici
dettato	Maskulin	dettati
dialogo	Maskulin	dialoghi
dipinto	Maskulin	dipinti
direttore	Maskulin	direttori
direttrice	Feminin	direttrici
discoteca	Feminin	discoteche
distributore	Maskulin	distributori
dito	Maskulin	dita(F)
ditta	Feminin	ditte
divano	Maskulin	divani
divertimento	Maskulin	divertimenti
dizionario	Maskulin	dizionari
dogana	Feminin	dogane
dolce	Maskulin	dolci
economia	Feminin	economie
entrata	Feminin	entrate
erba	Feminin	erbe
errore	Maskulin	errori
esame	Maskulin	esami
esempio	Maskulin	esempi
est	Maskulin	/
età	Feminin	età
etto	Maskulin	etti
faccia	Feminin	facce
facoltà	Feminin	facoltà
fattoria	Feminin	fattorie
febbre	Feminin	febbri
ferro	Maskulin	ferri
fetta	Feminin	fette
fiammifero	Maskulin	fiammiferi
fidanzata	Feminin	fidanzate
fidanzato	Maskulin	fidanzati
fine	Feminin	fini
firma	Feminin	firme
fiume	Maskulin	fiumi
foglio	Maskulin	fogli
formaggio	Maskulin	formaggi
fornello	Maskulin	fornelli
forno	Maskulin	forni
fortuna	Feminin	fortune
frase	Feminin	frasi
freddo	Maskulin	freddi
freezer	Maskulin	freezer
frigorifero	Maskulin	frigoriferi
fronte	Feminin	fronti
fulmine	Maskulin	fulmini
fuoco	Maskulin	fuochi
gamba	Feminin	gambe
garage	Maskulin	garage
gas	Maskulin	gas
gelato	Maskulin	gelati
genero	Maskulin	generi
genitore	Maskulin	genitori
geografia	Feminin	geografie
ghiaccio	Maskulin	ghiacci
ginnastica	Feminin	ginnastiche
giocattolo	Maskulin	giocattoli
gioco	Maskulin	giochi
giornalista	Maskulin,Feminin	giornalisti,giornaliste
giro	Maskulin	giri
gita	Feminin	gite
grado	Maskulin	gradi
guanto	Maskulin	guanti
guida	Feminin	guide
idea	Feminin	idee
identità	Feminin	identità
impermeabile	Maskulin	impermeabili
impiegata	Feminin	impiegate
impiegato	Maskulin	impiegati
infermiera	Feminin	infermiere
infermiere	Maskulin	infermieri
ingegnere	Maskulin	ingegneri
inizio	Maskulin	inizi
insalata	Feminin	insalate
isola	Feminin	isole
lampada	Feminin	lampade
lana	Feminin	lane
lavagna	Feminin	lavagne
lavanderia	Feminin	lavanderie
lavandino	Maskulin	lavandini
lavastoviglie	Feminin	lavastoviglie
lavatrice	Feminin	lavatrici
legno	Maskulin	legni
lenzuolo	Maskulin	lenzuoli(M),lenzuola(F)
libreria	Feminin	librerie
litro	Maskulin	litri
livello	Maskulin	livelli
luce	Feminin	luci
luna	Feminin	lune
luogo	Maskulin	luoghi
maiale	Maskulin	maiali
mancia	Feminin	mance
manica	Feminin	maniche
mano	Feminin	mani
matematica	Feminin	matematiche
materia	Feminin	materie
matrimonio	Maskulin	matrimoni
meccanico	Maskulin	meccanici
medico	Maskulin	medici
mela	Feminin	mele
mensa	Feminin	mense
merenda	Feminin	merende
messaggio	Maskulin	messaggi
metro	Maskulin	metri
metro	Feminin	metro
metropolitana	Feminin	metropolitane
minestra	Feminin	minestre
mobile	Maskulin	mobili
moda	Feminin	mode
mondo	Maskulin	mondi
monumento	Maskulin	monumenti
mostra	Feminin	mostre
motorino	Maskulin	motorini
mucca	Feminin	mucche
muro	Maskulin	muri
naso	Maskulin	nasi
natura	Feminin	nature
nave	Feminin	navi
nebbia	Feminin	nebbie
neve	Feminin	nevi
nipote	Maskulin,Feminin	nipoti
nord	Maskulin	/
nostalgia	Feminin	nostalgie
nuora	Feminin	nuore
nuoto	Maskulin	nuoti
nuvola	Feminin	nuvole
occhio	Maskulin	occhi
odore	Maskulin	odori
oggetto	Maskulin	oggetti
operaia	Feminin	operaie
operaio	Maskulin	operai
orario	Maskulin	orari
orecchio	Maskulin	orecchie(F)
oro	Maskulin	ori
ospite	Maskulin,Feminin	ospiti
ovest	Maskulin	/
padella	Feminin	padelle
padrona	Feminin	padrone
padrone	Maskulin	padroni
pagina	Feminin	pagine
paio	Maskulin	paia(F)
palazzo	Maskulin	palazzi
palestra	Feminin	palestre
palla	Feminin	palle
pallacanestro	Feminin	/
panino	Maskulin	panini
parente	Maskulin,Feminin	parenti
parete	Feminin	pareti
parte	Feminin	parti
partenza	Feminin	partenze
partita	Feminin	partite
passato	Maskulin	passati
passeggiata	Feminin	passeggiate
pasto	Maskulin	pasti
patata	Feminin	patate
patente	Feminin	patenti
paura	Feminin	paure
pausa	Feminin	pause
pavimento	Maskulin	pavimenti
peccato	Maskulin	peccati
pelle	Feminin	pelli
pensione	Feminin	pensioni
pentola	Feminin	pentole
pera	Feminin	pere
periferia	Feminin	periferie
persona	Feminin	persone
pettine	Maskulin	pettini
pezzo	Maskulin	pezzi
piede	Maskulin	piedi
pioggia	Feminin	piogge
pipa	Feminin	pipe
piscina	Feminin	piscine
pisello	Maskulin	piselli
pollo	Maskulin	polli
poltrona	Feminin	poltrone
ponte	Maskulin	ponti
posacenere	Maskulin	posacenere
posata	Feminin	posate
prato	Maskulin	prati
primo	Maskulin	primi
problema	Maskulin	problemi
profumo	Maskulin	profumi
programma	Maskulin	programmi
prosciutto	Maskulin	prosciutti
punto	Maskulin	punti
raffreddore	Maskulin	raffreddori
ragione	Feminin	ragioni
regalo	Maskulin	regali
resto	Maskulin	resti
riscaldamento	Maskulin	riscaldamenti
ritardo	Maskulin	ritardi
roulotte	Feminin	roulotte
rumore	Maskulin	rumori
sala	Feminin	sale
salame	Maskulin	salami
saldo	Maskulin	saldi
salotto	Maskulin	salotti
salsa	Feminin	salse
salute	Feminin	saluti
sandalo	Maskulin	sandali
sapone	Maskulin	saponi
sbaglio	Maskulin	sbagli
scala	Feminin	scale
sci	Maskulin	sci
scienza	Feminin	scienze
scontrino	Maskulin	scontrini
scrivania	Feminin	scrivanie
segretaria	Feminin	segretarie
segretario	Maskulin	segretari
semaforo	Maskulin	semafori
seta	Feminin	sete
shampoo	Maskulin	shampoo
sigaro	Maskulin	sigari
silenzio	Maskulin	silenzi
soccorso	Maskulin	soccorsi
soffitto	Maskulin	soffitti
sorpresa	Feminin	sorprese
spazzolino	Maskulin	spazzolini
specchio	Maskulin	specchi
spettacolo	Maskulin	spettacoli
spuntino	Maskulin	spuntini
squadra	Feminin	squadre
stadio	Maskulin	stadi
stanza	Feminin	stanze
stella	Feminin	stelle
stiro	Maskulin	/
stivale	Maskulin	stivali
storia	Feminin	storie
studio	Maskulin	studi
sud	Maskulin	/
suocera	Feminin	suocere
suocero	Maskulin	suoceri
tabaccaio	Maskulin	tabaccai
tappeto	Maskulin	tappeti
tasca	Feminin	tasche
tazza	Feminin	tazze
tecnico	Maskulin	tecnici
telefonata	Feminin	telefonate
temperatura	Feminin	temperature
tempo	Maskulin	tempi
temporale	Maskulin	temporali
tenda	Feminin	tende
tennis	Maskulin	/
terra	Feminin	terre
terrazza	Feminin	terrazze
testa	Feminin	teste
tetto	Maskulin	tetti
torta	Feminin	torte
tortellino	Maskulin	tortellini
tosse	Feminin	tossi
tovaglia	Feminin	tovaglie
tovagliolo	Maskulin	tovaglioli
traffico	Maskulin	traffici
tuono	Maskulin	tuoni
uccello	Maskulin	uccelli
uscita	Feminin	uscite
vasca	Feminin	vasche
vaso	Maskulin	vasi
vento	Maskulin	venti
verbo	Maskulin	verbi
vetrina	Feminin	vetrine
vetro	Maskulin	vetri
virgola	Feminin	virgole
voce	Feminin	voci
voglia	Feminin	voglie
volta	Feminin	volte
water	Maskulin	water
zia	Feminin	zie
zio	Maskulin	zii
abitante	Maskulin,Feminin	abitanti
accento	Maskulin	accenti
acconto	Maskulin	acconti
aglio	Maskulin	agli
alba	Feminin	albe
alloggio	Maskulin	alloggi
ambulanza	Feminin	ambulanze
ambulatorio	Maskulin	ambulatori
amicizia	Feminin	amicizie
analisi	Feminin	analisi
angolo	Maskulin	angoli
annuncio	Maskulin	annunci
ansia	Feminin	ansie
appunto	Maskulin	appunti
asilo	Maskulin	asili
assegno	Maskulin	assegni
attesa	Feminin	attese
attore	Maskulin	attori
attrice	Feminin	attrici
avverbio	Maskulin	avverbi
bagaglio	Maskulin	bagagli
bancomat	Maskulin	bancomat
banconota	Feminin	banconote
bilancia	Feminin	bilance
bilocale	Maskulin	bilocali
binario	Maskulin	binari
calma	Feminin	/
camion	Maskulin	camion
campo	Maskulin	campi
canale	Maskulin	canali
canguro	Maskulin	canguri
cantante	Maskulin,Feminin	cantanti
capodanno	Maskulin	capodanni
carnevale	Maskulin	carnevali
cartone	Maskulin	cartoni
cassettiera	Feminin	cassettiere
causa	Feminin	cause
cerotto	Maskulin	cerotti
cervello	Maskulin	cervelli
cimitero	Maskulin	cimiteri
cipolla	Feminin	cipolle
cliente	Maskulin,Feminin	clienti
clima	Maskulin	climi
clinica	Feminin	cliniche
coincidenza	Feminin	coincidenze
collegio	Maskulin	collegi
collezione	Feminin	collezioni
colloquio	Maskulin	colloqui
colpa	Feminin	colpe
commedia	Feminin	commedie
compagnia	Feminin	compagnie
complemento	Maskulin	complementi
Comune	Maskulin	Comuni
comunicazione	Feminin	comunicazioni
concorso	Maskulin	concorsi
condoglianza	Feminin	condoglianze
condominio	Maskulin	condomini
conoscenza	Feminin	conoscenze
consiglio	Maskulin	consigli
contante	Maskulin	contanti
copia	Feminin	copie
costruzione	Feminin	costruzioni
cuore	Maskulin	cuori
curriculum vitae	Maskulin	curricula vitae
denaro	Maskulin	denari
dentista	Maskulin,Feminin	dentisti,dentiste
dialetto	Maskulin	dialetti
diario	Maskulin	diari
dieta	Feminin	diete
diploma	Maskulin	diplomi
direzione	Feminin	direzioni
discesa	Feminin	discese
disoccupata	Feminin	disoccupate
disoccupato	Maskulin	disoccupati
dispensa	Feminin	dispense
documentario	Maskulin	documentari
dolore	Maskulin	dolori
duomo	Maskulin	duomi
elettricista	Maskulin,Feminin	elettricisti,elettriciste
elicottero	Maskulin	elicotteri
emergenza	Feminin	emergenze
emozione	Feminin	emozioni
esperienza	Feminin	esperienze
farina	Feminin	farine
favola	Feminin	favole
felicità	Feminin	felicità
feria	Feminin	ferie
ferita	Feminin	ferite
fiction	Feminin	fiction
fontana	Feminin	fontane
forma	Feminin	forme
forza	Feminin	forze
freno	Maskulin	freni
fretta	Feminin	frette
frullatore	Maskulin	frullatori
fumetto	Maskulin	fumetti
fumo	Maskulin	fumi
futuro	Maskulin	futuri
gara	Feminin	gare
genere	Maskulin	generi
gente	Feminin	genti
giardinaggio	Maskulin	giardinaggi
giocatore	Maskulin	giocatori
giocatrice	Feminin	giocatrici
gioia	Feminin	gioie
grammo	Maskulin	grammi
gruppo	Maskulin	gruppi
guasto	Maskulin	guasti
gusto	Maskulin	gusti
idraulico	Maskulin	idraulici
impegno	Maskulin	impegni
impianto	Maskulin	impianti
incendio	Maskulin	incendi
incidente	Maskulin	incidenti
incrocio	Maskulin	incroci
incubo	Maskulin	incubi
istituto	Maskulin	istituti
ladra	Feminin	ladre
ladro	Maskulin	ladri
laurea	Feminin	lauree
leone	Maskulin	leoni
liceo	Maskulin	licei
linea	Feminin	linee
lirica	Feminin	liriche
locale	Maskulin	locali
lotto	Maskulin	lotti
lupo	Maskulin	lupi
maestra	Feminin	maestre
maestro	Maskulin	maestri
malattia	Feminin	malattie
marca	Feminin	marche
marciapiede	Maskulin	marciapiedi
master	Maskulin	master
mensile	Maskulin	mensili
mensola	Feminin	mensole
metallo	Maskulin	metalli
metropoli	Feminin	metropoli
modo	Maskulin	modi
modulo	Maskulin	moduli
moneta	Feminin	monete
monolocale	Maskulin	monolocali
morte	Feminin	morti
motivo	Maskulin	motivi
motore	Maskulin	motori
notizia	Feminin	notizie
novità	Feminin	novità
occasione	Feminin	occasioni
odio	Maskulin	odii
offerta	Feminin	offerte
opera	Feminin	opere
opinione	Feminin	opinioni
ordine	Maskulin	ordini
ospitalità	Feminin	/
paese	Maskulin	paesi
parere	Maskulin	pareri
passaggio	Maskulin	passaggi
passione	Feminin	passioni
pazienza	Feminin	/
pediatra	Maskulin,Feminin	pediatri,pediatre
periodo	Maskulin	periodi
permesso	Maskulin	permessi
phon	Maskulin	phon
pieno	Maskulin	pieni
pillola	Feminin	pillole
pittore	Maskulin	pittori
pittrice	Feminin	pittrici
pittura	Feminin	pitture
pizzico	Maskulin	pizzichi
plastica	Feminin	plastiche
plurale	Maskulin	plurali
poesia	Feminin	poesie
poeta	Maskulin	poeti
poetessa	Feminin	poetesse
pompiere	Maskulin	pompieri
pop	Maskulin	/
porto	Maskulin	porti
possibilità	Feminin	possibilità
postino	Maskulin	postini
prefisso	Maskulin	prefissi
preposizione	Feminin	preposizioni
preside	Maskulin,Feminin	presidi
previsione	Feminin	previsioni
prezzemolo	Maskulin	prezzemoli
prodotto	Maskulin	prodotti
pronome	Maskulin	pronomi
pronuncia	Feminin	pronunce
protagonista	Maskulin,Feminin	protagonisti,protagoniste
pubblicità	Feminin	pubblicità
pulizia	Feminin	pulizie
quartiere	Maskulin	quartieri
questura	Feminin	questure
quotidiano	Maskulin	quotidiani
racchetta	Feminin	racchette
raccomandata	Feminin	raccomandate
regista	Maskulin,Feminin	registi,registe
reparto	Maskulin	reparti
rettore	Maskulin	rettori
ricetta	Feminin	ricette
ricordo	Maskulin	ricordi
risultato	Maskulin	risultati
rivista	Feminin	riviste
rock	Maskulin	/
romanzo	Maskulin	romanzi
ruota	Feminin	ruote
sacco	Maskulin	sacchi
salita	Feminin	salite
sapore	Maskulin	sapori
scaffale	Maskulin	scaffali
schiera	Feminin	schiere
schifo	Maskulin	/
sciopero	Maskulin	scioperi
sciroppo	Maskulin	sciroppi
sconto	Maskulin	sconti
scrittore	Maskulin	scrittori
scrittrice	Feminin	scrittrici
scultore	Maskulin	scultori
scultrice	Feminin	scultrici
scultura	Feminin	sculture
secolo	Maskulin	secoli
abilità	Feminin	abilità
abitazione	Feminin	abitazioni
abitudine	Feminin	abitudini
addetta	Feminin	addette
addetto	Maskulin	addetti
adolescente	Maskulin,Feminin	adolescenti
affare	Maskulin	affari
affermazione	Feminin	affermazioni
agio	Maskulin	agi
agricoltura	Feminin	agricolture
agriturismo	Maskulin	agriturismi
alimentazione	Feminin	alimentazioni
allarme	Maskulin	allarmi
ambiente	Maskulin	ambienti
amministratore	Maskulin	amministratori
amministratrice	Feminin	amministratrici
argomento	Maskulin	argomenti
arma	Feminin	armi
armonia	Feminin	armonie
artigianato	Maskulin	artigianati
asma	Feminin	asme
aspetto	Maskulin	aspetti
assassina	Feminin	assassine
assassino	Maskulin	assassini
assenza	Feminin	assenze
assicurazione	Feminin	assicurazioni
associazione	Feminin	associazioni
atteggiamento	Maskulin	atteggiamenti
attentato	Maskulin	attentati
attimo	Maskulin	attimi
attività	Feminin	attività
aumento	Maskulin	aumenti
autore	Maskulin	autori
autrice	Feminin	autrici
azienda	Feminin	aziende
azione	Feminin	azioni
base	Feminin	basi
bellezza	Feminin	bellezze
bolletta	Feminin	bollette
bollettino	Maskulin	bollettini
bomba	Feminin	bombe
bonifico	Maskulin	bonifici
brano	Maskulin	brani
bugia	Feminin	bugie
cadavere	Maskulin	cadaveri
cantiere	Maskulin	cantieri
capacità	Feminin	capacità
capitale	Feminin	capitali
carabiniere	Maskulin	carabinieri
carattere	Maskulin	caratteri
carcere	Feminin	carceri
carriera	Feminin	carriere
caso	Maskulin	casi
certificato	Maskulin	certificati
cieco	Maskulin	ciechi
cima	Feminin	cime
cittadinanza	Feminin	cittadinanze
coda	Feminin	code
collaboratore	Maskulin	collaboratori
collaboratrice	Feminin	collaboratrici
collocamento	Maskulin	collocamenti
colpevole	Maskulin	colpevoli
commento	Maskulin	commenti
commercio	Maskulin	commerci
comportamento	Maskulin	comportamenti
concorrenza	Feminin	concorrenze
conclusione	Feminin	conclusioni
condizione	Feminin	condizioni
conferenza	Feminin	conferenze
confronto	Maskulin	confronti
coniuge	Maskulin	coniugi
conseguenza	Feminin	conseguenze
considerazione	Feminin	considerazioni
consonante	Feminin	consonanti
contatto	Maskulin	contatti
contrario	Maskulin	contrari
contratto	Maskulin	contratti
convivente	Maskulin,Feminin	conviventi
coraggio	Maskulin	/
corrente	Feminin	correnti
cortesia	Feminin	cortesie
criminale	Maskulin,Feminin	criminali
crisi	Feminin	crisi
cronaca	Feminin	cronache
cura	Feminin	cure
danno	Maskulin	danni
dato	Maskulin	dati
debito	Maskulin	debiti
decisione	Feminin	decisioni
delusione	Feminin	delusioni
democrazia	Feminin	democrazie
denuncia	Feminin	denunce
deserto	Maskulin	deserti
desiderio	Maskulin	desideri
destinatario	Maskulin	destinatari
diavolo	Maskulin	diavoli
difetto	Maskulin	difetti
differenza	Feminin	differenze
difficoltà	Feminin	difficoltà
Dio	Maskulin	/,dèi
dipendente	Maskulin,Feminin	dipendenti
dipendenza	Feminin	dipendenze
dirigente	Maskulin,Feminin	dirigenti
discorso	Maskulin	discorsi
discussione	Feminin	discussioni
distanza	Feminin	distanze
divieto	Maskulin	divieti
dottorato	Maskulin	dottorati
droga	Feminin	droghe
dubbio	Maskulin	dubbi
educazione	Feminin	educazioni
elezione	Feminin	elezioni
epoca	Feminin	epoche
esercito	Maskulin	eserciti
espressione	Feminin	espressioni
evidenza	Feminin	evidenze
fastidio	Maskulin	fastidi
fatica	Feminin	fatiche
fede	Feminin	fedi
fiducia	Feminin	fiducie
figura	Feminin	figure
fila	Feminin	file
folla	Feminin	folle
fondo	Maskulin	fondi
formazione	Feminin	formazioni
fornitore	Maskulin	fornitori
furto	Maskulin	furti
galera	Feminin	galere
galleria	Feminin	gallerie
generazione	Feminin	generazioni
gesto	Maskulin	gesti
ghiacciaio	Maskulin	ghiacciai
giudice	Maskulin,Feminin	giudici
giustizia	Feminin	giustizie
globalizzazione	Feminin	globalizzazioni
governo	Maskulin	governi
guerra	Feminin	guerre
ideologia	Feminin	ideologie
immagine	Feminin	immagini
immobile	Maskulin	immobili
importanza	Feminin	importanze
impresa	Feminin	imprese
impressione	Feminin	impressioni
infanzia	Feminin	infanzie
inquilina	Feminin	inquiline
inquilino	Maskulin	inquilini
inquinamento	Maskulin	inquinamenti
intenzione	Feminin	intenzioni
interesse	Maskulin	interessi
interno	Maskulin	interni
intervista	Feminin	interviste
iscrizione	Feminin	iscrizioni
lato	Maskulin	lati
legge	Feminin	leggi
libertà	Feminin	libertà
maiuscola	Feminin	maiuscole
manager	Maskulin,Feminin	manager
mancanza	Feminin	mancanze
maniera	Feminin	maniere
maternità	Feminin	maternità
maturità	Feminin	/
mente	Feminin	menti
merce	Feminin	merci
messa	Feminin	messe
metodo	Maskulin	metodi
mezzo	Maskulin	mezzi
militare	Maskulin	militari
millimetro	Maskulin	millimetri
ministro	Maskulin	ministri
minuscola	Feminin	minuscole
miseria	Feminin	miserie
mittente	Maskulin,Feminin	mittenti
movimento	Maskulin	movimenti
multa	Feminin	multe
municipio	Maskulin	municipi
muro	Maskulin	muri(M),mura(F)
mutuo	Maskulin	mutui
nemico	Maskulin	nemici
omicidio	Maskulin	omicidi
onestà	Feminin	/
opportunità	Feminin	opportunità
organizzazione	Feminin	organizzazioni
pace	Feminin	paci
paesaggio	Maskulin	paesaggi
paga	Feminin	paghe
pagamento	Maskulin	pagamenti
Papa	Maskulin	Papi
parentesi	Feminin	parentesi
parlamento	Maskulin	parlamenti
partito	Maskulin	partiti
patto	Maskulin	patti
pena	Feminin	pene
personaggio	Maskulin	personaggi
personale	Maskulin	personali
personalità	Feminin	personalità
pietà	Feminin	/
pistola	Feminin	pistole
politica	Feminin	politiche
polizza	Feminin	polizze
povertà	Feminin	/
precedenza	Feminin	precedenze
preoccupazione	Feminin	preoccupazioni
preposizione	Feminin	preposizioni
presentazione	Feminin	presentazioni
presenza	Feminin	presenze
presidente	Maskulin,Feminin	presidenti
prestito	Maskulin	prestiti
prete	Maskulin	preti
prigione	Feminin	prigioni
principale	Maskulin	principali
probabilità	Feminin	probabilità
processo	Maskulin	processi
progetto	Maskulin	progetti
proposito	Maskulin	propositi
Provincia	Feminin	Province
puzza	Feminin	puzze
qualità	Feminin	qualità
questione	Feminin	questioni
quintale	Maskulin	quintali
rapina	Feminin	rapine
rapporto	Maskulin	rapporti
rata	Feminin	rate
realtà	Feminin	realtà